
[base]
AdminMode=超管模式
CleanAlarm=清理报错
ConfigMenu=配置菜单
Loading=加载中...
NoWorkSite=未设置
NotEditAny=您未修改任何内容
SignOut=登出
ToSystemConfig=系统配置
Unnamed=未命名
UserNotSignIn=未登录
WorkSite=工位
actionApiCallTraceConfig=配置接口调用记录
actionBatchCreateBins=批量创建库位，创建库位总数={}，其中 {} 个已存在
addParam=添加参数
addStatus=添加状态
belowEntityToBeFixed=以下业务对象被修复：
btnAddInputItem=添加录入项
btnAddParsingRule=添加解析规则
btnClearCache=清理缓存
btnCompare=比较
btnCopy=复制
btnDeleteInputItem=删除录入项
btnDirUp=向上
btnDirectCallContainer=出容器装货
btnDirectOutbound=直接出库
btnDownloadLog=下载日志
btnModify=修改
btnMultipleValue=多个不同值，修改
btnPaste=粘贴
btnRecover=恢复
btnReloadI18N=重新解析国际化字典
btnSetContent=设置内容
btnSignIn=登录
btnUnzip=解压
btnWwxSignIn=企业微信登录
btnZipDir=压缩目录
btn_mkdir=新建目录
btn_rm=删除
businessError=业务异常
clearByDay=按天清理
code=代码
configPageStatus=配置页面状态
confirmDeleteWidget=确定要删除控件吗？
confirmDownloadDir=确定要下载整个目录吗？
confirmRecoverVersion=确认恢复版本 {} 吗
confirmSystemEndEmergencyStop=确定要让系统结束急停状态吗？
confirmSystemToEmergencyStop=确定要让系统进入急停状态吗？任务、设备、机器人都将急停。
confirmToClearCache=确定要清理系统缓存吗？此操作可以大幅降低系统内存使用，但会导致系统性能下降一段时间。
dangerous=危险
dataSource=数据源
deleteWidget=删除控件
disConnectFromSever=与服务器连接中断
downOne=下一张
entityDetailListPage=业务对象列表页
entityDetailPage=业务对象详情页
errDingConfigError=钉钉配置错误
errFeiShuConfigError=飞书配置错误
errPasswordRequired=密码不能为空
errSelectOneDirectory=只能选择一个目录
errSelectOneFile=只能选择一个文件
errSelectOneFileOrDirectory=只能选择一个文件或目录
errUpToRootDir=已是根目录
errUsernameRequired=用户名不能为空
errWwxConfigError=企业微信配置错误
errorUpLoadFailed=上传失败
fixSqlQuestion=修复 SQL 相关问题：
fixSqlRecord=SQL 修复记录：
fixSqlTypeTo=修复{}.{}SQL类型为
hasDisabled=已停用
hasEnabled=已启用
hasOccurCountField=已发生数量字段（可选多个）
highLevel=高级
input=输入
jsonParsedError=JSON 解析错误
labeShowlMore=显示更多
labelAppId=应用 ID
labelAppSecret=应用密钥
labelArkConfig=通用大模型配置
labelAutoCommit=自动提交
labelBackBottom=前往底部
labelBackTop=返回顶部
labelBezier3=三次贝塞尔
labelBinOverview=库位一览
labelBlock=阻挡
labelCanSetInSetting=可在系统配置中修改保留天数
labelCancelKeepOpen=取消常开
labelClick=点击
labelCompare=比较
labelCompareMode=对比模式
labelConfigAi=AI
labelControlCar=控车
labelCurrentVersion=当前版本
labelCustomScriptCloseDoorFunName=控制关门的定制脚本方法
labelCustomScriptFetchReportFunName=获取门状态的定制脚本方法
labelCustomScriptOpenDoorFunName=控制开门的定制脚本方法
labelDataDict=数据字典
labelDebugUrl=调试地址
labelDegenerateBezier=高级三阶贝塞尔曲线
labelDetourType=绕道策略
labelDing=钉钉
labelDingSignIn=钉钉登录
labelDoubaoSttConfig=语音识别大模型配置
labelEnableDetour=是否允许绕道
labelEnableDynamicBalancingStrategy=是否开启路径规划动态均衡策略
labelEndDate=结束日期
labelErrorView=故障看板
labelExtralField=额外传输字段
labelFault=故障
labelFeiShu=飞书
labelFeiShuSignIn=飞书登录
labelFileSize=大小
labelFilename=文件名
labelForceArrivePointAfterCancel=取消机器人任务时要求机器人强制到点
labelHasSelectedRecord=您已选择 {} 条回放记录
labelImagePreview=图片预览
labelInValidIp=无效的IPv4地址
labelInitValue=初始值
labelIsNormal=正常
labelLoading=加载中
labelLoadingWait=处理中，请稍后
labelLogFleet=调度专用日志
labelLogFleetOp=调度回放
labelLogRange=日志范围
labelLogRbk=RBK 通讯日志
labelLogSystem=系统日志
labelMapMultipleValueEditor=处理多值
labelMapfType=全局规划算法
labelMenu=菜单
labelMenuGroup=菜单组
labelMenuItem=菜单项
labelModifiedBy=修改人
labelMore=更多
labelMyDesk=我的桌面
labelNoPrintNo=不打印的报文编号
labelNo_=编号
labelOpenDetialOnOneOption=列表页模糊搜索只有一个选项时，自动打开详情页
labelOpenMapf=开启全局规划
labelOpenScriptDebug=打开脚本调试
labelOpenStaticScan=开启静止检测
labelOrderType=单据类型
labelParsingRule=解析规则
labelPleaseInputExtBp=请输入定制组件名
labelPrintStatLog=打印系统监控的 Debug 日志
labelPythonDebugEnabled=启用 python 脚本 debug (生产环境禁用)
labelRecover=恢复
labelRefDirectInput=引用录入采用直接录入的方式
labelRobotBrakeDistance=机器人刹车距离（米）
labelRowNum=行数：{}
labelRowQuickInput=单行快速录入区
labelScriptCenter=脚本
labelScriptDebug=脚本调试
labelSepLabel=向上分离
labelServerFiles=服务器文件管理
labelSetKeepOpen=置为常开
labelSiteCountNum=库位数
labelStartDate=开始日期
labelStaticAngleSpeedThreshold=静止角速度阈值
labelStaticSpeedThreshold=静止速度阈值
labelSwitchMapConditionRetryNum=切换地图的最大重试次数
labelTaskHasClear=任务组件记录已清理
labelTaskInfo=任务信息
labelTaskRobotMode=任务模式
labelTaskStepDetail=任务步骤详情
labelTaskTemplateName=任务模板名
labelTaskVariable=任务变量
labelTestValue=测试值
labelThirdLogin=第三方登录
labelThreadName=线程名称
labelTmpFileSaveTime=临时文件保留时间（天）
labelVariable=变量名
labelVersionNumber=版本号
literalValue=直接值
modify=修改
msgConfirmRm=确定要删除以下文件吗：
msgInputDirname=请输入目录名
msgInputFieldName=请输入字段名
msgSignIn=Hi, 欢迎登录
msgSignInSuccess=登录成功
noStatusField=没有状态字段：
occurCountFieldList=本次发生数量字段列表
other=其他
percent=百分比
planAllField=计划总数量字段
pleaseResloveErrorFirst=请先解决一下关键错误：
px=像素
recentUse=最近使用
removeStatus=删除状态
reqSend=请求已发送
requiredCanNotBeEmpty=必填项不能为空
severError=服务器报错
smartTransManageSys=智能物流管理系统
sorryErrorOccur=抱歉！界面出错了！
specialValue=特殊值
statusFieldNotStartOptionList=状态字段未启用选项清单
systemEmergencyStop=系统已急停！
tabPage=标签页
tag-style-for-created=新建
tag-style-for-error=错误
tag-style-for-going=进行中
tag-style-for-success=成功
tag-style-for-warning=警告
tapToUploadImg=点击上传图片
testPage=测试页面
tipAddRowSuccess=添加行成功
tipDeleteTaskVariable=删除任务变量
tipDisplayNameEmpty=显示名不能为空
tipEditTaskVariable=编辑任务变量
tipEntityCodeParseExtJsEmpty=条码解析扩展代码不能为空
tipFieldBigger={} 字段必须大于 0
tipFieldRequired={0} 字段必填
tipInputItemEmpty=录入项不能为空
tipInputPassword=请输入密码
tipInputUsername=请输入用户名
tipInputYourWorkSite=请输入当前工位
tipInvalidRegex=无效的正则表达式
tipMappingFieldEmpty=字段不能为空
tipNotHistoryVersion=当前版本为初版，无历史版本
tipParseRuleEmpty=解析规则不能为空
tipProcessingModal=正在处理，请稍后...
tipRegexEmpty=正则表达式不能为空
tipScanNotAllowedError=未获取到摄像头权限
tipScanNotFoundError=未检测到摄像头
toViewBin=查看库位
toViewContainer=查看容器
toastLevel_error=错误
toastLevel_normal=说明
toastLevel_success=成功
toastLevel_warning=提醒
upOne=上一张
uploadImage=上传文件图片
wsGetOpenPage=WS 收到打开页面请求：
wsGetOpenPageStation=WS 收到打开页面请求，期望工位 {},，我的工位 {}

[base.vendor]
vendorHai=海柔
vendorHik=海康
vendorSeer=仙工

[base.button]
CollapseAll=全部收起
CollapseBtn=收起
ExpandAll=全部展开
ExpandBtn=展开
btnAbort=取消
btnAbortTask=取消任务
btnAdd=添加
btnAddCondition=添加条件
btnAddDownOrder=添加下游单据
btnAddForwardsStatus=添加后续状态
btnAddItem=添加项
btnAddMenuItem=添加菜单项
btnAddPart=添加段
btnAddReverseReflect=添加反写映射
btnAddRow=添加行
btnAddSingleHeadFieldReflect=添加单头字段映射
btnAddSingleLineFieldReflect=添加单行字段映射
btnAddUpOrder=添加上游单据
btnAdvancedSettings=高级配置
btnAutoReflect=自动映射
btnBack=返回
btnBatchAdd=执行
btnBatchEdit=批量编辑
btnBatchRemove=批量删除
btnCancel=取消
btnCancelEdit=取消编辑
btnCancelRun=取消执行
btnCheckAgain=重新检查
btnClearAlarm=清错
btnClearAll=清空
btnClearAllRow=清空行
btnClose=关闭
btnConfig=配置
btnConfirm=确定
btnCopyRow=复制行
btnDeleteOrder=删除此单据
btnDisable=停用
btnDisableSim=停用仿真
btnDone=完成
btnDownload=下载
btnEditAllField=编辑全部字段
btnEditRobotGroup=编辑机器人组
btnEnable=启用
btnEnableSim=启用仿真
btnExport=导出
btnFix=修复
btnFreeEdit=自由编辑
btnFreeSave=自由保存
btnFreeView=自由查看
btnGenerateExcelFile=生成 Excel 文件
btnImport=导入
btnInsert=插入
btnManage=管理
btnMoveDown=下移
btnMoveUp=上移
btnNextLine=下一行
btnNextPage=下一页
btnOpen=打开
btnPause=暂停
btnPauseRun=暂停执行
btnPrevLine=上一行
btnPrevPage=上一页
btnPublish=发布
btnPushMap=推送地图
btnPushOrder=下推
btnQuery=查询
btnReconnect=重连
btnRefresh=刷新
btnRemove=删除
btnRemoveCondition=删除条件
btnRemoveEntity=删除业务对象
btnRemoveGroup=删除组
btnRemoveItem=删除项
btnRemovePart=删除段
btnRemoveRow=删除行
btnRename=重命名
btnReset=重置
btnResume=继续
btnResumeRun=继续执行
btnRetry=重试
btnRetryFault=故障重试
btnRun=运行
btnSave=保存
btnSaveClose=保存并关闭
btnSelectAll=全选
btnSelectClear=清除选择
btnSelectFileToUpload=选择文件并上传
btnSelectNone=全不选
btnShowAll=显示全部
btnSourceCode=源码
btnStart=开始
btnSubmit=提交
btnSync=同步
btnTabCloseAll=关闭全部
btnTabCloseLeft=关闭左侧
btnTabCloseOther=关闭其他
btnTabCloseRight=关闭右侧
btnToCreate=新增
btnToEdit=编辑
btnToListView=列表界面
btnToView=查看
btnToViewDetail=查看详情
btnUpdate=更新
btnUpload=上传
btnZoomIn=放大
btnZoomOut=缩小
btnZoomReset=1:1
buttonKindError=危险
buttonKindNormal=普通
buttonKindPrimary=主按钮
buttonKindPrimaryLight=主按钮（浅色）
buttonKindSuccess=成功
buttonKindWarning=警告
labelAllRobotCount=所有机器人数
labelDisableCount=停用机器人数
labelEnableCount=启用机器人数
labelMockRobotDisconnect=断网
labelMockRobotForkHeight=货叉高度
labelProhibitedZone=禁行区
labelRobotCountInGroup=组内机器人数
labelRobotOperate=机器人操作
labelSourceCode=源码
labelTrafficOpenEnvCloud=地图资源管控：启用环境点云
labelTrafficOpenProhibitArea=地图资源管控：启用禁行区
labelTrafficOpenProhibitLine=地图资源管控：启用禁行线
tipResetRobot=确定要“重置”机器人吗？“重置”将取消机器人的所有运单，清空机器人身上的库位状态，并将机器人重置为空闲状态。如果已载货，请确保货物已从机器人身上取走。如果遇到故障，请尽量点击“故障重试”。

[base.action]
actionCopySuccess=复制成功
actionDangerActionWarning=危险操作警告
actionFail=失败
actionFilterByLabel=按 {} 筛选
actionImportSuccess=导入成功
actionNoFilter=不能筛选
actionPasteSuccess=粘贴成功
actionPullDone=拉取成功
actionRemoved=已删除
actionReqSuccess=请求成功
actionSaveSuccess=保存成功
actionSubmitSuccess=提交成功
actionSubmitted=已提交
actionSuccess=成功
actionToPushOrder=下推成功

[base.confirm]
confirm=确认
confirmNoChangeToSave=未检测的变化，是否继续保存？
confirmToAbortOneTask=确定要取消此任务吗？
confirmToCancelSave=确定取消编辑吗？
confirmToDoBtn=确定要执行 '{0}' 吗？
confirmToRemove=确定要删除吗？
confirmToRemoveId=确定要删除 {0} 吗？
confirmToRemoveItemsNum=确定要删除 {0} 条数据吗？
confirmToRemoveLineNum=确定要删除 {0} 行数据吗？
confirmToRetryOneTask=确定要尝试重新执行此任务吗？
confirmToRetryTask=确定要尝试重新执行 {} 个任务吗？
confirmToSave=确定要保存吗？
titleConfirm=确认

[entity.order]
amount=金额：
backCount=让步数量：
buyCount=采购数量：
hasCompleteCount=已完工数量：
hasConfirmDispatchCount=已确认发货数量：
hasConfirmTakeCount=已确认交货数量：
hasDispatchFromWarehouseCount=已出库数量：
isNotOrderEnableFirst=不是单据，请先启用单据
needReceiveCount=应收数量:
orderHasDownDownFieldReflectNoFill=单据 [{}] 有下下推字段映射未填完整
orderHasDownStatusNoBtn=单据 [{}] 有下推状态未填按钮
orderHasDownStatusNoID=单据 [{}] 有下推状态未填 ID
orderHaskindNoID=单据 [{}] 有类型未填 ID
orderHaskindNoName=单据 [{}] 有类型未填名称
orderHaskindNoShowName=单据 [{}] 有类型未填显示名
passCount=合格数量：
planDoCount=计划生产数量：
price=价格：
promiseGoodsCount=本次到货数量：
promiseReachDate=约定到货日期：
realReceiveCount=实收数量：
rejectCount=拒收数量：
thisDispatchCount=本次发货数量：

[base.label]
btnEnableBzKind=启用业务类型
btnResetDemoData=重置演示数据
cautionGoodsFieldAutoReflectNotConfig=注意：物料属性字段会自动映射，不需要配置
confirmResetDemoData=确定要重置演示数据吗？涉及清空数据库、修改调度场景等多个危险操作，请慎重进行。
confirmToRemoveEntity=确定要删除此业务对象吗？
labeBtnType=按钮种类
labelAcceptableTimeout=超时等待时长
labelActions=操作
labelActiveGetTime=运动信息获取周期 （ms）
labelAddSpecial=添加特殊字段
labelAddStep=添加步骤
labelAlign=对齐方式
labelAlignRight=靠右显示
labelAll=全部
labelAllExpand=全部展开
labelAllFold=全部折叠
labelAlpha=不透明度
labelAreaFillColor=区域填充色
labelAutoFill=自适应
labelAutoReload=自动刷新
labelBase=基本
labelBaseConfig=基础配置
labelBaseInfo=基本信息
labelBasic=基础
labelBatch=批次
labelBatchCreateBin=批量创建库位
labelBatchOperation=批量操作
labelBatchSelectTip=已选择 {} 个告警项
labelBgColor=背景颜色
labelBgSize=背景大小
labelBlur=模糊
labelBorder=边框
labelBorderAndColor=边框与字体颜色
labelBottomBorder=下边框
labelBtnKind=按钮级别
labelBtnText=按钮显示文字
labelBtnType=按钮类型
labelBzKind=业务类型
labelCache=缓存
labelCacheTip=检测到有未保存的缓存，是否加载，最后记录时间:
labelCallTimeout=调用超时（毫秒）
labelCanCharge=可充电
labelCanModifyOrder=可修改单据
labelCanPark=允许停靠
labelCancelTasking=取消任务中
labelCancelled=已取消
labelCategory=类别
labelCenter=居中
labelCenterAlign=居中
labelChangeLogs=修改记录
labelChangePic=更换图片
labelChildApp=子应用
labelClickUpload=点击上传文件
labelColor=颜色
labelColorPicker=选择颜色
labelColumn=列
labelColumnNumberEnd=列号结束
labelColumnNumberStart=列号开始
labelColumnNumberWidth=列号位数
labelColumnWidth=列宽
labelColumns=列数
labelColumnsSelectCanMixed=列宽选择"撑满列"时,可补充以下信息：
labelComment=评论
labelCompanyID=企业 ID
labelCompanyName=企业名称
labelCompanySecret=企业秘钥
labelCompareOp=比较方式
labelComponentList=组件列表
labelConfirmMsg=确认消息
labelContainer=容器
labelContent=内容
labelCopy=拷贝
labelCopySet=拷贝配置
labelCore=核心
labelCreate=创建
labelCreatedBy=创建人
labelCreatedOn=创建时间
labelCronExpress=Cron 表达式
labelCrossColumn=跨列
labelCrossColumnNo=跨列数
labelCss=样式
labelCssClass=CSS 类名
labelCssStyle=CSS 样式
labelCtxParams=上下文参数
labelCustomColor=定制颜色
labelCustomEnabled=启用定制
labelCustomIcon=定制图标
labelDataDbWarningRecord=故障记录记录警告级别
labelDataLocalBackup=数据库本地备份
labelDataManage=数据管理
labelDb=数据库
labelDecimalNum=小数位数
labelDeep=深
labelDefaultSpace=默认空间
labelDefaultValue=默认值
labelDeleteEditCtrl=删除/编辑控制
labelDeleteEntityWaring=请注意不是删除数据，而是删除此业务对象，整个数据结构和表都会被删除。可能导致系统崩溃且无法恢复，请慎重操作。请输入要删除业务对象名。
labelDeleteSpace=删除空间
labelDeleteSpaceConfirm=确定删除空间：{} 吗？
labelDeleteSuccess=删除成功
labelDeprecatedFeature=过时功能
labelDepthNumberingEnd=深度结束
labelDepthNumberingStart=深度开始
labelDepthNumberingWidth=深度位数
labelDepthOn=启用深度（多深位）
labelDetailLayout=详情页布局
labelDev=开发
labelDevConfig=开发配置
labelDisableBatchEdit=禁用批量编辑
labelDisableCharge=禁止充电
labelDisableCreate=禁用创建
labelDisableExport=禁用导出
labelDisableImport=禁用导入
labelDisablePark=禁止停靠
labelDisableRemove=禁用删除
labelDisableSetting=禁用设置
labelDisableUpdate=禁用更新
labelDisabled=已停用
labelDisabledBtn=禁用按钮
labelDisplay=显示
labelDisplayLabel=显示名
labelDisplayNameCantNull=显示名不能为空
labelDisplayOrder=显示顺序
labelDownOrderInitStatus=下游单据初始状态
labelDownOrderReverseStatus=下游单据反写时的状态
labelDownOrderType=下游单据类型
labelEditStep=编辑步骤
labelEditing=编辑中
labelEmpty=空
labelEnableCharge=启用充电
labelEnablePark=启用停靠
labelEnabled=已启用
labelEnabledScan=启用扫码
labelEndedOn=结束时间
labelEntity=业务对象
labelEntityIndex=业务对象列表
labelEntityListFilter=业务对象列表筛选
labelEntityListTableHeight=业务对象列表表格高度
labelEntityName=业务对象字段名
labelEntityNoNotPerfixn=业务对象 [{}] 编号前缀未填
labelEntityNotName=业务对象没有名字
labelEntitySummaryEntityNotExist=字段 {} 摘要字段 {} 不存在
labelEntityTheName=业务对象名
labelEntryRemark=录入说明
labelErrorMsg=报错
labelExcuteBatchOperationTip=将对 {} 个告警执行{}操作，请确定。
labelExisting=已有的
labelExpandColumn=撑满列
labelExportInput=请输入空间名称（将作为文件名）
labelExportSpace=导出回放空间
labelExportSuccess=导出成功
labelExporting=导出中...
labelExtPage=定制页面
labelFailure=故障
labelFailureRecord=故障记录
labelFalconTaskDef=猎鹰任务
labelFalconTaskDefAfterSave=猎鹰任务（保存后）
labelFalconTaskDefBeforeSave=猎鹰任务（保存前）
labelFieldCustom=字段定制
labelFieldCustom_tip=操作基于字段原配置生效：字段配置不显示，仅“不显示”生效；字段配置只读，“不显示”和“只读”生效；字段配置可编辑，全部操作生效。
labelFieldName=字段名
labelFieldSum=字段合计
labelFilters=筛选
labelFinalStatus=终态
labelFitContent=适应内容
labelFixedWidth=固定宽度
labelFlexDirection=flex 方向
labelFolateNum=小数
labelFolderBacup=备份文件夹
labelFontBold=粗
labelFontMiddle=中
labelFontSize=字号
labelFontThin=细
labelFontWeight=字重
labelForbiddenRotAngle=禁止旋转角度
labelFormLayout=表单布局
labelForwardsStatus=后续状态
labelFromDown=从下游
labelFromUp=从上游
labelFullWorkSpace=撑满工作区
labelGe=格
labelGeHao=格号
labelGoSelfZone=自由导航区
labelGoods=物料
labelGoodsImg=物料图片
labelGoodsKindName=物料分类名称
labelGoodsKindNo=物料分类编号
labelGoodsModel=物料型号
labelGoodsName=物料名称
labelGoodsNo=物料编号
labelGoodsStandard=物料规格
labelGreen=绿色
labelGroup=组
labelGroupName=组名
labelHeight=高度
labelHideIfBlankFalse=空值/假值时隐藏
labelHistory=历史
labelHorizontalDirection=水平方向
labelHttpMethod=方法
labelHttpPath=路径
labelIcon=图标
labelIconPicker=选择图标
labelIconPickerInputPlaceholder=请输入英文
labelId=标识
labelImport=导入
labelImportOpSpace=导入回放空间
labelImportSpace=导入空间
labelImportSuccess=导入成功
labelImported=导入的
labelImporting=导入中...
labelInfoGetTime=全量信息获取周期 （ms）
labelInfoTip=提示
labelInput=输入框
labelInputError=输入错误
labelInputParams=输入参数
labelInputVar=输入变量
labelInsertWidget=插入控件
labelInvalidSelectedOption=无效的选项：{0}
labelKeyPos=关键位置
labelLabel=标签
labelLang=语言
labelLastModifiedBy=最后修改人
labelLastModifiedOn=最后修改时间
labelLayer=层
labelLayerNumberEnd=层号结束
labelLayerNumberStart=层号开始
labelLayerNumberWidth=层号位数
labelLeafNode=叶节点
labelLeft=居左
labelLeftAlign=左对齐
labelLeftBorder=左边框
labelLength=长度
labelLevel=等级
labelLine=单行
labelLineHeight=行高
labelLineNo=行号
labelLinePartRight=与下一项的间距
labelListStr=请输入数组字符串-例
labelLoadOnly=仅载货通过
labelLoadPass=载货、空载通行
labelLockToScreenUp=锁定到屏幕上方
labelLogo=企业 LOGO
labelLookStep=查看步骤
labelMain=主要
labelMapDown=地图之下
labelMapUp=地图之上
labelMapping=直接映射
labelMappingField=映射到字段
labelMaxWidth=最大宽度
labelMenuItemLabel=定制菜单项名称
labelMessage=消息
labelMessageNotice=消息提醒
labelMinWidth=最小宽度
labelModel=型号
labelModel_tip=目前主要用于显示。
labelModified=已修改
labelModifiedFields=修改了：
labelModifiedOn=修改时间
labelModifiedTime=修改时间
labelMonitorError=监控页面报错
labelMutexZone=互斥区
labelName=名称
labelNeedRefreshCurrentConfig=当前配置需要刷新页面生效
labelNeedRefreshPartConfig=部分配置需要刷新页面生效
labelNewComponent=新组件
labelNewTemplate=新模板
labelNo=否
labelNoAdvancedQuery=不显示高级查询
labelNoAnyWidget=当前无任何组件~
labelNoAvoid=不允许避让
labelNoLimit=不限制
labelNoLoadOnly=仅空载通行
labelNoMainActions=不显示工具栏
labelNoModified=无修改
labelNoOrder=暂无运单
labelNoPrefix=编号前缀
labelNoQueryActions=不显示查询栏
labelNoStepFixed=暂不封口
labelNoText=无文本
labelNone=无
labelNormal=普通
labelNormalBtn=普通按钮
labelNormalLayout=通用布局
labelNotAsMenuItem=不作为菜单项
labelNotEnabled=不启用
labelNotVisual=不显示
labelNotWrite=标签内容未填
labelNotice=通知
labelObjectTypes=对象类型
labelOp=操作
labelOpImportFileZip=导入的文件为回放页面的 zip 文件
labelOpSpace=回放空间
labelOptionBill=选项清单
labelOrange=橙色
labelOrder=运单
labelOrderAsc=升序
labelOrderDesc=降序
labelOrderNo=单号
labelOrderOwner=所属订单
labelOrderState=业务状态
labelOrgSet=机构配置
labelOutputParams=输出参数
labelOverTime=超时
labelPaddingInside=内留白 padding
labelPaddingOutside=外留白 padding
labelPage=页面
labelPageConfig=界面配置
labelPageName=页面名称
labelPageShowName=页面显示名
labelPageWidth=页面宽度
labelPanelFixText=请在详情面板中修改文字
labelParamCantEmpty=参数名不能为空
labelParamName=参数名
labelParamObjectType_BinId=库位编号
labelParamObjectType_ContainerId=容器编号
labelParamObjectType_ContainerType=容器类型名
labelParamObjectType_CtoId=容器搬运单号
labelParamObjectType_DistrictId=库区编号
labelParamObjectType_EntityFieldName=业务对象字段名
labelParamObjectType_EntityId=业务对象 ID
labelParamObjectType_EntityName=业务对象名
labelParamObjectType_OrderId=单号
labelParamObjectType_PlcDevice=PLC 设备
labelParamObjectType_SiteId=站点
labelParkIdleTime=生成停靠任务前的空闲时间（s）
labelParsing=解析录入
labelPasteSet=粘贴配置
labelPermitDownPushStatus=允许下推时的状态
labelPhoneEntityPageBtnFlat=移动端业务对象主界面按钮平铺
labelPlanQuanitity=计划数量
labelPleaseComplete=请将必填项填写完整
labelPleaseInputRequired=请填写必要参数
labelPleaseSelectOne=请先在列表页至少选择一行数据
labelPort=端口
labelPosIniting=重定位初始化中
labelPosSuccess=重定位成功
labelPrefix=前缀
labelPrefixPaddingLeft=后缀左侧留白大小
labelPrefixPaddingRight=前缀右侧留白大小
labelPresetColor=系统预设色
labelPrintHTTPClientLog=打印 HTTP客户端请求日志
labelPrintLog=将 TCP 解码器收到的原始报文打在日志里
labelPrintTCPSuccess=打印 TCP 写完成
labelPrintWSClientLog=打印 WebSocket 客户端日志
labelPriority=优先级
labelProperty=属性
labelPwdErrCountResetDelay=密码错误次数重置时间（单位：秒）
labelPwdErrLimit=允许密码错误次数（为空则不限制）
labelPwdExpireDays=密码过期时间（为空则不限制，单位：天）
labelPwdMaxLen=密码最大长度（默认值 20）
labelPwdMinLen=密码最小长度（默认值 1）
labelPwdStrengthLevel=密码强制限制
labelPwdStrengthLevelModerate=中密码（包含字母数字，至少 8 位）
labelPwdStrengthLevelStrong=强密码（包含大小写字母数字特殊符号，至少 12 位）
labelPwdStrengthLevelWeak="弱密码（至少 1 位）"
labelQuanitity=数量
labelQueryTaskOrWidget=筛选任务或组件...
labelQuickStore=QuickStore
labelRealPlanQuanitity=实际数量
labelReceivedOn=接收时间
labelRecentCreatedEntity=最近创建的
labelRecognizeForkParam=识别并叉取参数
labelRecordInputParam=记录显示组件输入参数
labelRecordRequest=记录请求
labelRecordRequestBody=记录请求正文
labelRecordResponseBody=记录响应正文
labelRed=红色
labelRefCPCantEmpty=引用组件不能为空
labelRefCPParamCantEmpty=引用组件输出参数不能为空
labelRefFilter=引用筛选
labelRefObj=引用对象
labelRefObjFilter=引用对象筛选
labelRefreshNo=暂不刷新
labelRefreshNow=立即刷新
labelRegex=正则表达式
labelRelatePoint=关联点位
labelRelocing=正在重定位
labelRemain=默认保持
labelRemark=说明
labelRemarkZone=说明区
labelReportAlarm=上报故障
labelRequestDelay=请求时间间隔（毫秒）
labelRequired=必填
labelRightAlign=右对齐
labelRightBorder=右边框
labelRobot=机器人
labelRobotInfo=机器人信息
labelRow=排
labelRowNumberEnd=排号结束
labelRowNumberStart=排号开始
labelRowNumberWidth=排号位数
labelRows=行数
labelSaveMaxDay=最多保留几天
labelScript=脚本
labelScriptFuncName=后端脚本函数名（不触发保存）
labelScriptFuncNameAfterSave=后端脚本函数名（保存后）
labelScriptFuncNameBeforeSave=后端脚本函数名（保存前）
labelSearchAlarmCodeOrMessage=搜索告警码或告警消息
labelSeconds=秒
labelSelectDate=选择日期
labelSelectDateTime=选择日期时间
labelSelectEleFirst=请先选择元素
labelSelectTime=选择时间
labelSelectedCount=已选择 {} 项
labelSelfDataShow=自定义数据展示
labelSettings=设置
labelShadow=阴影
labelShadowXOffset=偏移 X
labelShadowYOffset=偏移 Y
labelSingleOp=动作
labelSiteArea=库区
labelSizeWeight=尺寸权重
labelSorts=排序
labelSpaceList=空间列表
labelSpecialLayout=特殊字段布局
labelSpecialPosition=特殊位置
labelStack=层叠
labelStandard=标准
labelStandardPage=标准页面
labelStartExport=开始导出
labelStartUse=启用
labelState=状态
labelStatusColor=状态颜色
labelStatusInfo=状态信息
labelStatusInstruction=状态说明
labelStatusLabel=状态标签
labelStatusValue=状态标识
labelStatusValue_tip=同一业务对象下的状态标识不能重复
labelString=字符串
labelSubBtn=次按钮
labelSuffix=后缀
labelSystemExisting=系统当前版本
labelTabPageTab=标签页标签
labelTapLeftWidgetInsertWidget=请点击左侧组件插入组件
labelTapPageRightUpInsertWidget=请点击页面右上角按钮插入组件
labelTapUpInsertWidget=请点击上方“插入组件”按钮插入组件
labelTargetContainerDir=终点放置容器的方向
labelTaskBatch=料箱车任务组
labelTaskId=任务 ID
labelTemplateList=模板列表
labelText=文字
labelTextColor=文字颜色
labelTheLine=第 {0} 行
labelThePart=第 {} 段
labelThisRobot=指定机器人
labelThisRobotGroup=指定机器人组
labelToDown=到下游
labelToUp=到上游
labelTopBorder=上边框
labelTopNode=顶层节点
labelTxtContent=文字内容
labelTxtContentNoSet=未设置文字内容
labelTxtSize=文字大小
labelType=类型
labelUiHttpTimeout=界面与服务器 HTTP 通讯默认超时（秒）
labelUnloadContainerDir=放料架时的料架方向
labelUpLevel=上级
labelUpLineNo=上游行号
labelUpOrderStatusFilter=上游单据状态筛选
labelUpOrderType=上游单据类型
labelUploadProgress=上传进度：{0}%
labelUserSecurity=用户安全
labelValue=值
labelVersionManagement=版本管理
labelVerticalAlign=垂直（轴）对齐
labelVerticalDirection=垂直方向
labelViewCreate=新建
labelViewEdit=编辑
labelViewRead=查看
labelVisualOnlyMe=仅我可见
labelWarehouse=仓库
labelWarehouseHasDeal=库存已处理
labelWarehouseWork=仓储业务
labelWaringBtn=警告按钮
labelWeChatWork=企业微信
labelWidth=宽度
labelWillImported=要导入的版本
labelYes=是
labelbtnText=按钮文字
labelhorizontalAlign=水平（轴）对齐
lablCount=计数
laeblImportDesc=导入说明:{} 1. 导入文件的格式为 xlsx，即 Excel 文件。{}2. 首次导入，可使用“导出”功能导出一份文件，作为“导入模板”。
layout=布局
layoutBox=布局盒子
lebelLevel=等级
listPageBatchBtn=列表界面批量按钮
logDeviceClient=打印设备客户端日志
singleCurrentOrder=当前运单
tipMenuGroupItemsEmpty=请给菜单组添加至少 1 个菜单项
tipMenuGroupNameEmpty=请给菜单组命名
tipMenuItemTargetEmpty=请给菜单项选择对应页面
tipPwdErrLimit=输入错误超过指定次数，账户锁定，管理员可以手工清零 “密码错误计数”。-1 即不限制
tipPwdExpireDays=如果密码过期，禁止登录。管理员手工改密码、通过修改密码接口改密码，更新“密码设置时间”。-1 即永不过期
tipStatusValue=状态标识不能重复
totalCount=共 {}

[base.tip]
labelClearDoorSignalInterval=清空关门信号的等待时间
labelInputMax20=输入最大长度超出 20
labelSuggestTime=推荐值 1000~3000
tipAlarmNum=共 {} 条告警
tipApiCallTrace=记录以下接口请求
tipNoConfig=无配置
tipNoNextPage=已是最后一页
tipNoPrevPage=已是第一页
tipNone=无
tipNote=便签
tipProcessing=正在处理请稍后...
tipSelectEntity=您可以进行多次查询、搜索、翻页。先勾选要选择的项，最后批量提交。
tipSelectExcelToImport=请选择要导入的 Excel 文件
tipSelectOneRowAtLeast=请至少选择一行
tipUpOrderEdit=请选择上游单据类型和单号
tipUpOrderRead=已选择上游单据类型和单号

[base.page]
pagingDesc=第 {0} 页 共 {1} 页 共 {2} 条 每页 {3} 条
pagingPageNoPrefix=第
pagingPageNoSuffix=页
pagingPageNum=共 {0} 页
pagingPageSizePrefix=每页
pagingPageSizeSuffix=条
pagingTotal=共 {0} 条

[base.error]
=label
errColumnNoErr=列编号配置错误
errDeptNoErr=深度配置错误
errFieldNameDuplicated=字段名重复 '{}'
errFileTooLarge=文件大小过大
errHttp403=403 没有权限。
errHttp404=404 找不到
errHttp413=413 请求太大，超过限制
errHttp500=500 服务器错误
errHttpError=HTTP 错误
errLayerNoErr=层编号配置错误
errNetworkError=网络错误
errNotImpl=未实现
errReqTimeout=请求超时
errRowNoErr=排编号配置错误
errSaveCreateBeforeRun=新建的任务需要先保存才能运行
errSaveToRun=部分修改未保存，需要先保存再运行
errSelectOneAtLeast=请先选择至少一个
errSelectOneTaskAtLeast=请先选择至少一个任务
errorNoDialogBuilder=错误：找不到对话框构建器
errorNoPageBuilder=错误：找不到页面构建器

[entity.query]
CommonQuery=常用查询
FuzzySearch=快速搜索，回车...
MySavedQuery=我的查询方案
PublicSavedQuery=公共查询方案
QueryAddAndItems=添加 AND 组
QueryAddItem=添加筛选条件
QueryAddOrItems=添加 OR 组
QueryAlreadyCase=此方案已保存为常用查询，
QueryCaseName=方案名
QueryItem=条件
QueryItemGroup=条件组
QueryRelationAndTip=AND 且
QueryRelationOrTip=OR 或
alarm=告警
btnAddToQuery=添加到当前筛选条件
btnCommonQuery=常用
btnNewQuery=新查询
btnQueryByThis=直接筛选
btnRecentQuery=最近
btnRemoveQueryCase=删除此方案
btnSaveAsNewCase=保存为新方案
cqAll=所有
cqAnd=且
cqOr=或
labeLink=链接
labelAny=任意值
labelAsc=升序
labelBigger=大于
labelBiggerEqual=大于等于
labelBool=布尔
labelCurrentUserID=当前用户 ID
labelCurrentUserName=当前用户名
labelDate=日期
labelDes=降序
labelEditable=可编辑
labelEleType=元素类别
labelFalconTaskTemplate=猎鹰任务模版
labelFile=文件
labelFilterRobot=筛选机器人...
labelFloat=浮点数
labelHidden=不显示
labelHierarchicalData=层级数据
labelInt=整数
labelIsEmpty=空文本
labelIsNotEmpty=非空文本
labelIsNotNull=有值 NOT NULL
labelIsNull=无值 NULL
labelJSONArray=JSON 数组
labelJSONObject=JSON 对象
labelLess=小于
labelLessEqual=小于等于
labelLong=长整数
labelMockRobotMaster=控制者
labelMultiValue=多个值
labelNoEqual=不等于
labelNormalPage=标准界面
labelPassword=密码
labelPlanName=方案名称
labelRange=范围
labelReadonly=只读
labelRefer=引用
labelRichText=富文本
labelSelect=选择
labelSelectList=选项列表
labelSelectPlaceholder=请选择
labelSingleton=单例
labelSpecialPage=定制界面
labelSum=求和
labelTextContains=文字包含
labelTextContainsIgnore=文字包含（忽略大小写）
labelTextEndsWith=文字结尾是
labelTextStartsWith=文字开头是
labelTextarea=多行文本框
labelThisWeek=本周
labelToday=今天
labelWidget=组件
laeblDateTime=日期时间
laeblImage=图片
tableDataLoading=表数据量加载中...
tipCurrentQuery=当前查询
tipInputQueryCaseName=请输入方案名称
tipRecentQuery=最近查询
tipSaveQueryCase=您可以将此查询方案保存下来，方便后续再次查询
titleQueryCase=查询方案管理

[entity.export]
ExportSelectFields=选择导出字段：
ExportSelectRows=提示：已选中 {0} 行
ExportSelectTargets=选择导出范围：
ExportSelectedButSelectNone=请先选择要导出的单行，或指定筛选条件
ExportToDownload=文件已生成，请点击下载
ExportToExecute=执行：
ExportTypeAll=全部数据
ExportTypeQuery=自定义查询
ExportTypeSelected=选定范围
labelLineExported=导出单行

[entity]
EntityValueNotFoundById=找不到数据（ID={0}）
LineNoLineNum=第 {} 行，共 {} 行
PleaseInputRemark=请输入说明
btnToOrderHead=单头详情
btnToOrderLines=单行详情
labelAllDISK=全盘
labelAllDiskDownload=全盘下载模式
labelDownOrders=下游单据
labelHotKey=快捷键
labelLoadNames=下载白名单
labelNotSearchElement=未搜索到相关元素
labelOrderHead=单头
labelTapEscOut=按 Esc 退出框选模式
labelUpOrders=上游单据
tipSelectPushOrderType=请选择要下推的单据类型

[auth]
btnCopyFieldPermission=拷贝字段权限
btnCopyPermission=拷贝权限
btnPasteFieldPermission=粘贴字段权限
btnPastePermission=粘贴权限
pEditAllowed=允许编辑
pEntityLabel=业务对象权
pFeatLabel=功能项权
pFieldLabel=字段权
pItemList=权限清单
pLabelAllEdit=全部编辑权限
pLabelAllMenu=全部菜单权限
pLabelAllPerm=全部权限
pLabelAllRead=全部查看权限
pMenuLabel=菜单权
pReadAllowed=允许查看
pRowLabel=数据行权
pTitleByBzUnit=按业务单元赋权

[entity.config]
EntityBatchEditConfirm=您将对 {0} 条数据的以下字段进行修改：{1}。
EntityBatchEditTip=您选择了 {0} 条数据进行批量修改。下面，请先勾选要批量修改的字段，再进行修改。
FieldNoRefEntity=字段 {0} 未配置'关联业务对象（refEntity）'
LabelButtonEnabledCq=显示条件
actionCreateEntity=创建业务对象
actionEditEntity=修改业务对象
actionExportEntity=导出业务对象
actionImportEntity=导入业务对象
actionRemoveEntityOne=删除单个业务对象
btnAddAllBuiltinButton=添加全部默认按钮
btnAddButton=添加按钮
btnAddCommonEntityFields=添加常用字段
btnAddEntity=添加业务对象
btnAddField=添加字段
btnAddRowAllowed=允许添加新行
btnAddRule=添加规则
btnCloneField=复制字段
btnCopyToCp=拷贝到剪切板
btnCreateComponentEntityMeta=创建组件业务对象
btnEditEntityMeta=编辑业务对象
btnPasteFromCp=从剪切板粘贴
btnRemoveField=删除字段
btnResetBuiltin=重置内建
btnSyncDb=更新数据库结构
btnToList=列表页
confirmResetEntityMeta=确定要删除所有定制的业务对象、清除对内建对象的修改吗？
confirmResetEntityMetaBuiltin=确定要清除对内建对象的修改吗？
confirmToRemoveFields=确定要删除 {} 个字段吗？
confirmToSyncDb=确定要更新数据库结构吗？这是危险操作，请确认。
entityButtonConfigMissing=扩展按钮的配置不全
entityButtonNoExtIdHandler=前端特殊功能不存在：'{0}'
errCloneEntityName=新业务对象的名字和现实名不能为空，且不能与原业务对象相同。
errEntityFieldValueListItemNumMax='{}' 字段，最多不能超过 {} 项
errEntityFieldValueListItemNumMin='{}' 字段，至少录入 {} 项
errEntityFieldValueRequired='{}' 不能为空
errEntityLabelExist=业务对象 "{}" 显示名称已存在
errEntityNameExist=业务对象 "{}" 已存在
errFieldNameSpecial=不能使用字段名 '{}'，它有特殊含义，请换个名字。
errNoSuchEntityByName=找不到业务对象 '{}'
labelAbort=报错
labelAtLeastOne=至少输入一个
labelBuiltinButtonOp=内建按钮功能
labelButtonEnabledCondition=启用条件显示（满足条件才显示）
labelButtonExtOp=调用特殊功能
labelButtonUiSource=前端扩展代码
labelButtonUiSourceAfter=前端扩展代码（保存后）
labelButtonUiSourceBefore=前端扩展代码（保存前）
labelCalcCode=计算脚本
labelCanSavePlanToSearch=您可以将此搜索方案保存下来，方便后续再次查询
labelComputed=计算公式
labelCopiable=可拷贝
labelDataClean=数据清理
labelDemoCodeParse=示例条码
labelDeprecated=弃用
labelDetailsPageName=替换详情页
labelDisabledFilter=有停用/禁用功能
labelDisabledImport=禁止导入
labelEntityCard=卡片
labelEntityChangedPostProcess=业务对象改变后处理代码
labelEntityCodeParse=条码解析
labelEntityCodeParseExtJs=条码解析扩展代码
labelEntityCommentOn=启用评论
labelEntityDigest=摘要
labelEntityEditTip=新增编辑界面提示语
labelEntityHistoryOn=启用历史版本
labelEntityIdFlowNoWidth=流水号位数
labelEntityIdGenOn=启用自动编号
labelEntityIdGenOnText=自动编号
labelEntityIdPrefix=编号前缀
labelEntityIndexTip=列表界面提示语
labelEntityListStats=列表统计
labelEntityOpIndex=首页是操作页面
labelEntityOrder=单据
labelEntityPushOrder=下推单据
labelEntityScale=数量关系
labelEntitySort=默认排序
labelEntityTrackChangeOn=启用修改记录
labelEntityTrashOn=启用回收站
labelEntityViewOpenMode=详情页打开方式
labelEntity_showBuiltin=显示系统内建业务对象
labelEntity_showBuiltinCore=显示系统核心业务对象
labelEntity_showDisabled=显示停用的业务对象
labelExtCode=扩展代码
labelField=字段
labelFieldCore=字段核心
labelFieldList=字段
labelFieldMap=字段映射
labelFieldRefFilter=引用输入筛选
labelFieldScale=多值
labelFieldTip=字段备注
labelFieldView=字段视图
labelFieldView_Hidden_Hidden_Hidden=不显示、不显示、不显示
labelFieldView_Readonly_Editable_Editable=只读、可编辑、可编辑
labelFieldView_Readonly_Hidden_Hidden=只读、不显示、不显示
labelFieldView_Readonly_Readonly_Readonly=只读、只读、只读
labelFileMD5=计算文件MD5
labelFuzzyFilter=模糊筛选
labelImageField=图片字段
labelInputType=输入方式
labelLineColumnWidth=组件表格列宽度
labelLinesSortAllowed=允许单行排序
labelListItemNumMax=列表最多多少项
labelListItemNumMin=列表最少多少项
labelListTableColumnAlign=列表表格列对齐
labelListTableColumnWidth=列表表格列宽度
labelListTableDisabled=列表表格不显示
labelNeedSplitValue=需输入逗号分隔的值
labelNewEntityLabel=新对象显示名
labelNewEntityName=新对象名
labelNoticeEvent=通知事件
labelNoticeTarget=通知人
labelOldEmName=原业务对象
labelOnFieldChangeExt=字段改变后触发扩展代码
labelOtherDatasource=定制数据源
labelPageButtons=界面按钮
labelParsedPart=解析内容示例
labelPbBackEndApi=后端接口
labelPbBackEndButton=后端按钮
labelPbButtonTypeBuiltin=内建按钮
labelPbButtonTypeExt=扩展按钮
labelPbButtonTypeSpecial=特殊扩展按钮
labelPbCreate=新增界面
labelPbEdit=编辑界面
labelPbListItem=列表项按钮
labelPbListMain=列表主按钮
labelPbPreSep=前方添加分隔
labelPbView=详情界面
labelQuickInput=快速录入
labelRbkProtocol3_5=RBK 3.5 协议
labelRefEntity=关联业务对象
labelRefField=引用字段：本业务对象检测字段
labelRefFieldField=引用字段：取值路径
labelReplaceText=替换显示内容
labelRulePrefix=规则 {}
labelSelectEntity=选择业务对象 {}
labelShowAsTag=作为标签显示
labelSpecialInput=特殊输入
labelSqlDb=SQL 数据库
labelSqlDbType=SQL 数据类型
labelSqlLength=最多字符数
labelSqlLengthTruncate=当文本过长时截断存储
labelSqlNumScale=小数位数
labelSqlNumWidth=数字位数（含小数）
labelStartRbkProtocol3_5=启用 RBK 3.5 协议
labelStateField=状态字段
labelSumLineField=汇总单行字段
labelTableStyleExtCode=表格样式扩展代码
labelTagStyle=标签样式
labelUpOrder=上游单据
labelValueCantEmpty=值不能为空
labelValueNeedTwo=需输入2个值
labelViewAsBlock=宽显示
labelViewScanInput=扫码录入
msgLineNotFound=匹配不到单行
optionEntityCardCompareEq=等于
optionEntityCardCompareOther=其他
optionEntityCardPartTypeConditional=根据值
optionEntityCardPartTypeSimple=简单
optionViewOpenModeDialog=对话框
optionViewOpenModePage=页面
pageBatchEditEntity=批量编辑业务对象
pageEntityIndex=业务对象首页
tipLineSearchFilterParse=条码解析 / 搜索定位
toConfigEntity=配置业务对象：
toConfigFalcon=配置猎鹰任务：

[dataClean]
labelCountDays={} 天
labelEmDataCleanType=数据清理方式
labelEmKeepDays=数据保留天数

[stats]
btnCopyCondition=复制方案
btnDeleteCondition=删除方案
btnExportToExcel=导出为 Excel
btnSaveCondition=保存方案
btnStatsRange=重新生成当前周期的报表
btnStatsTotal=立即统计时间序列表
labelAddCustomPlan=新增自定义方案
labelAddSearchPlan=新增搜索方案
labelCalendarDate=日
labelChart=图表
labelCollapseStatsCondition=收起统计条件
labelCreateM4=您可以导入此项目包，或者在右上角关闭引导页，从零开始创建您的 M4 项目。
labelCustomPlan=自定义方案
labelCustomSearchPlan=自定义搜索方案
labelDisableLog=禁用日志
labelDisableStats=禁用统计
labelExpandStatsCondition=展开统计条件
labelFilterCondition=筛选方案…
labelImportM4=导入初始项目包
labelMonth=月
labelNewCondition=新统计
labelNextStep=下一步
labelPeriodicReport=周期报表
labelPleaseInputPlanName=请输入方案名称
labelPleaseInputPlanType=请输入方案类别
labelSeqIndex=序号
labelStatistics=统计
labelStatsCondition=统计条件
labelStatsDashboard=统计看板
labelStatsDelayTime=统计延迟时间(ms)
labelStatsEndTime=结束时间
labelStatsName=方案名
labelStatsPeriod=时间
labelStatsPeriodType=周期类型
labelStatsRange=统计范围
labelStatsStartTime=开始时间
labelStatsSubject=统计科目
labelStatsTarget=统计对象
labelSumField=合计字段
labelSysPlan=系统方案
labelTable=表格
labelUseEasyConfig=为方便您的快速使用，减少配置，M4 内置了初始项目包，预先配置好了菜单、业务对象、调度场景、猎鹰任务等。
labelWeek=周
labelWelcomeM4=欢迎使用 M4！
labelYear=年
labelZeroCreateM4=从零开始创建项目
periodTypeDay=日报
periodTypeDay_30=近 30 天
periodTypeDay_7=近 7 天
periodTypeHour=时报
periodTypeMonth=月报
periodTypeQuarter=季报
periodTypeWeek=周报
periodTypeYear=年报
tipConditionNameEmpty=方案名不能为空
tipConditionNameExist=统计方案名已存在
tipDateRange=开始时间必须小于结束时间
tipDeleteConditionConfirm=你确定要删除统计方案吗？
tipOnlyMultiSelectOne=统计科目、统计对象只能有一个多选
tipStatsEmpty=请选择查询科目
tipStatsNotQueryEmpty=未查询到统计数据
tipStatsRangeEmpty=请选择时间范围
tipSubjectEmpty=统计科目不能为空
tipTargetEmpty=统计对象不能为空

[falcon.global]
confirmRemoveVariable=确认删除变量 {} 吗？
labelAddDesc=添加说明
labelAddRemark=添加备注
labelAddVariable=新增变量
labelDefVariable=定义变量
labelDescContent=请输入说明内容
labelGloablControl=全局变量
labelGlobalVariablesLabel=全局变量
labelModifyVariable=修改变量
labelRefObject=引用实体
labelRefObjectFilter=引用实体筛选
labelSearchVariable=搜索变量
labelUnAddDesc=未添加备注

[falcon]
FalconBlockStatus_200=创建
FalconBlockStatus_220=执行
FalconBlockStatus_250=故障
FalconBlockStatus_260=完成
FalconBlockStatus_280=取消
FalconBlockStatus_290=失败
actionAddBp=插入组件
actionRemoveBp=移除组件
btnAddExtBp=添加定制组件
btnAddGroup=新建分组
btnAddTaskDef=添加任务模板
btnDeleteExtBp=删除定制组件
btnDeleteTaskDef=删除任务模板
btnFixed=固定
btnNotFindTaskDef=找不到任务定义
btnRedo=重做
btnShowLog=显示日志
btnToTaskDef=任务模板
btnUndo=撤销
btnViewSubTask=查看子任务
cancelFalconTask=取消执行猎鹰任务
confirmDeleteExtBp=确定删除 {} 个定制组件吗
confirmDeleteTaskDef=确定删除 {} 个任务模板吗
confirmFalconCancel=确定要取消 {} 个任务吗？
confirmFalconCancelOne=确定要取消任务吗？{}
confirmFalconPause=确定要暂停 {} 个任务吗？
confirmFalconRecoverError=确定要尝试重新执行 {} 个任务吗？
confirmFalconRecoverErrorOne=确定要尝试重试故障的任务吗？{}
confirmFalconResume=确定要继续执行 {} 个任务吗？
confirmRemoveBlocks=确定要删除以下组件吗？
confirmRemoveBp=确定要删除 {} 个组件吗
errNoRedo=没有可重做的操作了
errNoUndo=没有可撤销的操作了
falconLabelBpDesc=组件说明
falconLabelBpExtFunc=调用函数
falconLabelBpExtLang=内联代码语言
falconLabelBpLabel=组件显示名
falconLabelBpName=组件名
falconLabelChildBp=子组
falconLabelChildGroupName=子组名
falconLabelChildMax=最多包含几个子组件
falconLabelChildMin=最少包含几个子组件
falconLabelChildName=子组件名
falconLabelConfigChildren=配置子组
falconLabelConfigInputParams=配置输入参数
falconLabelConfigOutputParams=配置输出参数
falconLabelExtBp=自定义组件
faultCount=故障次数:
labelAddFilter=添加筛选
labelAnimateGood=动态障碍物
labelBinId=库位编号
labelBinStatus=库位状态
labelBlockReason=被阻挡原因
labelBlockRecordRetentionDay=猎鹰任务组件记录保留天数，默认 7 天；最小 1 天
labelBpName=组件引用名
labelBuiltInTask=内建任务
labelBzFlow=业务流程
labelCallLift=呼叫电梯
labelCallLiftSuccess=电梯已呼叫
labelCamera3D=虚拟激光点
labelCantEmpty={} 不能为空
labelCantGoFloor="{}" 不能前往楼层 "{}"
labelCarDirection=车头朝向
labelChangeToDouble=变为双向线
labelChangeToSingle=变为单向线
labelChargingOrderDoneOn=充电运单结束时间
labelCloseDoor=关门
labelCloseDoorSuccess=电梯已关闭
labelClosedDoor=已关门
labelClosingDoor=关门中...
labelCollision=碰撞传感器
labelComplex=复杂
labelConfigBp=配置组件
labelContainerId=容器编号
labelCopyError=文本复制失败
labelCoreOrderWidget=二代调度运单组件
labelCreateFalconTaskDef=新建猎鹰任务
labelCrossRobot=经过的机器人
labelCurrentFloor=当前楼层
labelCurrentRunOrderStep=正在执行的运单步骤
labelCustomLabel=定制标签
labelDefaultGroup=默认分组
labelDeleteSelectImg=删除所选图片
labelDeleteSelectText=删除所选文字
labelDeleteTaskDefAndExtBp=删除任务模板和定制组件
labelEasy=简单
labelEditFalconTaskDef=编辑猎鹰任务
labelElementDetail=元素详情
labelEmulateLight=虚拟激光点
labelEveythingOk=一切安好
labelExpressionNotWrite=表达式未填
labelExtGroup=定制组件分组
labelFallingDown=防跌落传感器
labelFixedFilter=固定筛选
labelHasCopied=已复制到剪切板
labelHasInitInTraffic=机器人在交管中已初始化
labelInfrared=红外传感器
labelInputGroupName=请输入分组名称
labelInternalVariables=内部变量
labelJumpToNo=跳转到第
labelLaser=激光
labelLastRobotReportChargeTime=最新一次机器人上报正在充电的时间
labelLiftQueue=排队机器人
labelLock=锁车开关
labelMapMatch=地图匹配
labelMaxLoadNum=最大负载数
labelMoreTaskSettings=更多任务设置
labelNavId=当前路径导航 ID
labelNavStatus=当前路径导航状态
labelNdcWidget=NDC组件
labelNoCustom=不支持定制
labelNotFindTaskDef=未找到任务块定义
labelNotParamCantRun=未输入 {} 任务无法运行
labelOpenDoor=开门
labelOpenedDoor=已开门
labelOpeningDoor=开门中...
labelOperationNotWrite=operation参数未填
labelOperator=运算符
labelOrderInfo=运单信息
labelOrderRejectReason=机器人不能接单原因
labelOwnerRobotGroup=所属机器人组
labelPathCanGoOrBack=路径不限制正走倒走
labelPathMustAhead=路径必须正走
labelPathMustForward=路径必须倒走
labelPlusOneMode=N + 1 模式
labelPositionInfo=位置信息
labelPrefixCtx=上下文:
labelPrefixOutput=输出:
labelRecentReq3066s=最近机器人导航指令
labelRefBp=引用组件
labelRefBpOutput=引用组件输出参数
labelRelatedOrder=关联运单
labelReportingChargingOn=最新充电上报时间
labelRestrictLine=禁行线
labelReversePath=反转方向
labelRobotBin=机器人库位
labelRobotBinInfo=机器人库位信息
labelRobotBlockedBy=阻挡我的机器人
labelRobotCardStyle=机器人列表样式
labelRobotDoingKeyAction=关键动作
labelRobotIdleFrom=机器人开始空闲时间
labelRobotOrder=运单列表
labelRobotRunStatus=执行状态
labelRobotWillMoveActions=动作列表
labelRunTask=运行任务
labelSaveAndSearch=保存并查询
labelScheduleControl=调度控制
labelSelectAllAP_Point=选择全部 AP 站点
labelSelectAllChargePoint=选择全部充电点
labelSelectAllHuanXiangPoint=选择全部可换向点
labelSelectAllNotAvoidPoint=选择全部不允许避让点
labelSelectAllParkPoint=选择全部可停靠点位
labelSelectAllSpinPoint=选择随动点位
labelShortSideAhead=路径窄边向前
labelSingleWidget=单车组件
labelStepPos=步骤位置
labelStepRejectReason=不能执行步骤的原因
labelSubTask=子任务
labelSyntaxReference=语法参考
labelTargetFloor=目标楼层
labelTask=任务
labelTaskAlarm=警告
labelTaskDefGroup=任务模板分组
labelTaskGroup=分组
labelTaskInput=任务输入
labelTaskInputParams=任务输入参数
labelTaskLabel=任务名
labelTaskNameNotEmpty=任务名称不能为空
labelTaskNowStatus=任务当前状态
labelTaskOutputParams=任务输出参数
labelTaskSettings=任务设置
labelTimesDay=天
labelTimesNum=次
labelTotalCycleCount=共循环 {} 次
labelTotalSelectElement=共选中 {} 个元素
labelTotalSelectPathShow=共选中 {} 个路径，最多展示 10 个。左侧可筛选已选中路径的方向
labelTrafficToDealTask=交管任务
labelTravelledPointNames=已经过的点位
labelUltrasonic=超声
labelUnTravelPointNames=未经过的点位
labelUsingRobot=正在使用的机器人
labelVariableNotWrite=变量名未填
linkObject=相关对象
msgInputNewFalconTaskDefName=请输入新任务模板名
optionBpIpTypeExpression=表达式
optionBpIpTypeRef=引用
optionBpIpTypeSimple=固定值
orderModifyTimeAsc=按修改时间升序
orderModifyTimeDesc=按修改时间降序
orderNameAsc=按名称升序
orderNameDesc=按名称降序
pauseFalconTask=暂停执行猎鹰任务
resumeFalconTask=继续执行猎鹰任务
retryFalconTask=故障重试猎鹰任务
sectionFalconExtBp=定制组件
sectionFalconTaskDef=任务模板
sheduleOrder=调度运单
simpleValue=简单值
tipAddTaskInputParam=添加任务输入参数
tipAddTaskOutParam=添加任务输出参数
tipAddWidget=添加组件
tipConfigWidgetInputParam=配置组件输入参数
tipCopyWidget=拷贝组件
tipDeleteExtBpGroup=确定删除以下内容吗? 只删除分组则组内组件移动到默认分组
tipDeleteSingleWidget=删除单个组件
tipDeleteTaskDefAndExtBp=确定删除以下内容吗? 只删除分组则组内内容移动到默认分组
tipDeleteTaskDefGroup=确定删除以下内容吗? 只删除分组则组内模板移动到默认分组
tipDeleteTaskInputParam=删除任务输入参数
tipDeleteTaskOutPutParam=删除任务输出参数
tipEditTaskInputParam=编辑任务输入参数
tipEditTaskOutPutParam=编辑任务输出参数
tipFixedToPage=固定到界面
tipGroupExist=该分组名称已存在、请修改
tipInsertVariable=点击插入变量
tipMoveToGroup=移至分组
tipMoveWidget=移动组件
tipRemoveWidget=删除选中的组件
tipSelectToDelete=请选择要删除的内容
tipUnFixed=取消固定
titleFalconTaskDefList=猎鹰任务管理
titleTaskDetail=任务详情
unableGetMsg=无法获取信息

[page]
btnAddMenuGroup=添加菜单组
labelMenuConfig=菜单配置
labelMenuName=菜单名
pageFalconTaskDefList=猎鹰任务管理
pageFleet=车队管理
pageMap=地图
pageMetaIndex=业务对象
pageMyDesk=我的桌面
pageOpControl=运维中心
pageOpDashboard=运营看板
pagePlcMonitor=PLC 设备监控
pagePlcPanel=PLC 设备面板
pageSoc=系统监控
pageSystemConfig=系统配置
pageTomOrder=调度(CORE)运单

[entity.index]
btnAddIndexField=添加索引字段
btnRemoveIndex=删除索引
btnRemoveIndexField=删除字段
errIndexFieldNoName=索引字段未配置
errIndexNameDuplicated=索引名不能重复
errIndexNameRequired=索引名不能为空
errIndexNoFields=索引未配置字段
labelIndexName=索引名
labelIndexUnique=唯一索引
sectionEntityIndex=数据库索引

[db.export]
btnCleanOldDataNow=立即清理历史数据
btnDbDump=导出数据库
btnDbRestore=导入数据库
confirmToCleanOldDataNow=确定要立即清理历史数据吗？业务对象按配置的清理规则清理。请谨慎操作。清理会在后台进行，需要一定时间。
dbDumpSuccess=导出成功，请下载
dbRestoreSuccess=导入完成，请刷新界面
labelRemoveOldData=删除已有数据
txtDbDumpProgress=正在导出业务对象 {0}，已完成 {4} 条，共 {3} 条，共 {2} 个业务对象，当前第 {1} 个。
txtDbRestoreProgress=导入业务对象：{0}，导入 {3} 条，文件进度：{1}/{2}。
txtDbRestoreProgress2=删除已有业务对象：{0}，进度：{1}/{2}。

[script]
btnReloadScript=重启脚本
btnResourceLock=资源锁
btnRobustRun=后台任务
confirmToReloadScript=确定要重启脚本吗？
labelOtherFn=附加功能

[fleet.gw]
gwAuthId=网关用户ID
gwAuthSecret=网关登录秘钥
gwHTTPServer=HTTP 服务器
gwLocalRobotName=本地机器人名
gwLocalRobots=本地机器人
gwReportApplyTitle=上报&申领任务模式
gwReportApplyTitleTip=上报地址可以填多个，逗号分隔，按顺序上报，直到成功。
gwReportUrl=上报地址
gwSinglePortRbkServerTip=RBK TCP 协议需要多个端口。如果因为防火墙、光通讯等原因只能有一个端口。
gwSinglePortRbkServerTitle=单端口 RBK 服务器
gwTipHttpServer=HTTP 服务器对外提供 HTTP 服务。可以用 HTTP 给机器人发指令。'用户 ID' 和 '用户秘钥' 是必填的。
gwTipLocalRobots=机器人名字必须唯一。对于仙工机器人，必须填 IP。
gwTipWebSocketClients=我们作为 WebSocket 客户端连接到远程服务器。如果机器人在内网，服务器在外网，必须以客户端从内网发起连接。启用 Gzip 压缩通讯。
gwTipWebSocketServer=WebSocket 服务器对外系统 WebSocket 服务。可以通过 WebSocket 客户端给机器人发指令。'用户 ID' 和 '用户秘钥' 是必填的，用于 WebSocket 客户端请求时验证身份。
gwWebSocketClients=WebSocket 客户端
gwWebSocketServer=WebSocket 服务器
labelGwEnableGw=启用网关
labelGwVendor=厂商
labelSimulated=仿真
labelSplitScreenToShow=请选择要将屏幕分成几行几列
titleGwConfig=网关配置

[wcs.plc]
PLCMonitor=PLC 设备监控
btnAddDataPoint=添加数据点
confirmDeletePanel=确定要删除此面板吗？
dataPointError=数据点 [{}] 报错：
getDataPointFailed=获取数据点 [{}] 失败
labelAddressBitOffest=地址-比特偏移量
labelAddressByteOffest=地址-字节偏移量
labelBit=比特
labelDBno=DB 号
labelDataArea=存储区域
labelDataType=数据类型
labelEmulateS7=S7 仿真
labelFloat32=32 位浮点数
labelFloat64=64 位浮点数
labelInt16=有符号 16 位整数
labelInt32=有符号 32 位整数
labelLocalDateTime=本地日期时间
labelLocalTime=本地时间
labelPlcPanelSettings=面板配置
labelPlcReconnectConfirm=确定要重连这些 PLC 吗 {}
labelS7Value=s7 值
labelTime=时间
labelUint16=无符号 16 位整数
labelUint32=无符号 32 位整数
modbusReadInputDevice=0x04 读取输入寄存器
modbusReadKeepDevice=0x03 读取保持寄存器
modbusReadLiSanInput=0x02 读取离散量输入值
modbusReadTheCoilStatus=0X01 读取线圈状态
modbusReadTheInputStatus=0X02 读取输入状态
modbusReadXianQuanInput=0x01 读取线圈/离散量输出值
modbusWriteMoreDevice=0x10 写多个寄存器
modbusWriteMultiCircle=0x0F 写多个线圈
modbusWriteSingle=0x05 写单个线圈
modbusWriteSingleDevice=0x06 写单个寄存器

[fleet]
ConnectionType_FleetToRobot_tip=需填写机器人IP
ConnectionType_GwWs_tip=需配置GW
ConnectionType_RobotToFleet_tip=机器人端需要配置调度 IP、端口。
RobotBinStatusLabels_Cancelled=理
RobotBinStatusLabels_Clear=清
RobotBinStatusLabels_Empty=空
RobotBinStatusLabels_Filled=占
RobotBinStatusLabels_Reserved=预
arcPath=圆弧
bezierPath=贝塞尔曲线
blockList=块列表
btn=按钮
btnAddBz=添加业务线
btnAddChargeConfig=添加充电策略
btnAddCompleexTest=添加复杂测试
btnAddContainerType=添加容器类型
btnAddDor=添加门
btnAddEasyTest=添加简单测试
btnAddLift=添加电梯
btnAddRobot=添加机器人
btnAddRobotGroup=添加机器人组
btnAddSmPoint=添加 SM 点
btnBatchEdge=批量连线
btnCancelMockScene=取消一键仿真
btnCheckMatch=检查匹配
btnDisableScene=停用场景
btnEditMap=编辑
btnEditRobot=编辑机器人
btnEditSceneArea=编辑区域
btnEnableScene=启用场景
btnEndMakeEdge=结束连线
btnExcute=执行
btnExportScene=导出场景
btnGenOrderJsonFile=生成 orders.json 文件
btnImportLandmark=导入站点
btnImportMap=导入地图
btnImportRdsCoreScene=导入 RDS CORE 场景
btnImportRobotSmap=获取机器人当前 smap
btnImportScene=导入场景
btnInsertZone=插入区块
btnLoadMap=加载地图
btnMakeEdge=连线
btnMarkRead=标记为已读
btnMockScene=一键仿真
btnModifySceneName=修改场景名
btnPullAndUpdate=拉取并更新场景
btnPullMapFromRobot=从机器人拉取地图
btnPush=推送
btnPushAsync=后台推送
btnPushMapToRobot=推送地图给机器人
btnReReadRobotParam=重新读取机器人库位参数
btnRefreshRobotList=刷新机器人列表
btnRemoveArea=删除区域
btnRemoveChargeConfig=删除充电策略
btnRemoveContainerType=删除容器类型
btnRemoveDoor=删除门
btnRemoveLift=删除电梯
btnRemoveRobot=删除机器人
btnRemoveRobotGroup=删除机器人组
btnRemoveScene=删除场景
btnRobotRuntimeRecord=运行记录
btnSelectNotMatchRobot=仅选择不匹配的机器人
btnUploadMap=上传地图
btnUploadSmap=上传 smap 文件
callBacking=正在回调
cancelOrder=取消运单
checkbox=框选
confirmAsyncPushTip=是否进行异步推送，系统将在后台选择合适的时间进行推送。
confirmAsyncPushTitle=异步推送
confirmCancelAsyncPushTip=将取消未推送完成的机器人，确定取消?
confirmCancelMockScene=确定要一键取消仿真吗？
confirmCreateSimRobot=是否同时创建仿真机器人
confirmDisableScene=确定要停用场景吗？
confirmEnableScene=确定要启用场景吗？
confirmMockScene=确定要一键仿真吗：自动创建仿真机器人、门、电梯。
confirmRemoveArea=确定要删除区域吗？
confirmRemoveContainerType=确定要删除容器类型吗？
confirmRemoveRobot=确定要删除机器人吗？
confirmRemoveRobotGroup=确定要删除机器人组吗，删除机器人组将同时删除组内所有机器人！
confirmRemoveScene=确定要删除场景吗？
confirmRemoveThing=确定要删除吗？
confirmRetryPleaseConfirmRobot=确定要重试吗？请确定机器人在当前步骤的起点或终点，再执行恢复！如果把机器人挪走了，请挪到正确的地方再重试。
confirmToDisableRobots=确定要停用机器人吗？
confirmToEnableRobots=确定要启用机器人吗？
confirmToImportLandmark=确定要导入 {} 个站点吗？
confirmToRemoveInMap=已选中 {} 个站点，{} 条路径，{} 个区域，确定删除吗？
confirmToRemoveRobots=确定要删除 {} 个机器人吗？
controlCar=控车
currentStepInfo=当前步骤信息：
delete=删除
disConnect=断连
end=终点：
errEdgeExists=已有路径
errMapAtLeastOneArea=至少要有一个区域
errNoOnlineSeerRobot=没有在线的仙工机器人
errNoSiteSelected=未选中任何站点
errNoTargetSite=未选中有效的目标站点
errorRobotNameRequired=机器人名不能为空
errorRobotNameUniqInScene=机器人名在整个场景中必须唯一
finishTime=完成时间
hasSend=已发送
hisStep=第 {} 步
hisStepTotalStep=第 {} 步，共 {} 步
importSmapFromRobot=请选择一个机器人，导入机器人当前地图
insertPoint=插入站点
labeSheduleId=调度 ID
labelAbnormal=异常
labelAdapterInfo=适配器信息
labelAdapterType=适配器类型
labelAdaptor=适配器
labelAddedRobotCount=新增机器人数量
labelAddress=地址
labelAlarmChar=警
labelAllSelectGroupedRobot=全选组内机器人
labelAllSelectRobot=全选机器人
labelAllocationReject=分配拒绝原因
labelArea=区域
labelAreaCount=区域数
labelAreaFloor=区域楼层
labelAreaMaps=区域地图
labelAutoRecovery=智能恢复
labelAxis=坐标轴
labelBaseSize=基本尺寸
labelBatteryLevel=电量
labelBelongArea=所属区域
labelBinTask=binTask
labelBlockChar=挡
labelBottomView=仰视图
labelBtnClean=清除
labelBundleSearch=批量搜索
labelCargoSafeHeight=载货行走高度
labelChargeConfig=充电策略
labelCheckboxZoomIn=框选放大
labelChecking=检查中...
labelClearImage=清空图片
labelCloseFunName=关门函数名
labelCloud=点云
labelCloudOpacity=点云不透明度
labelCmdStatusUnknown=任务状态未知
labelCmd_1=发到特定点位等待
labelCmd_10=指定容器类型（Container-type-1）和容器编号（container-1）
labelCmd_11=完整示例
labelCmd_2=取放货
labelCmd_3=多步骤
labelCmd_4=指定机器人
labelCmd_5=指定优先级为 3
labelCmd_6=指定仿真机器人出生点为 PP2
labelCmd_7=指定 binTask（目标点填写库位）
labelCmd_8=指定放货容器角度为 90 °
labelCmd_9=指定容器类型（Container-type-1）
labelCollisionModel=碰撞模型
labelCollisionModel_tip=按照机器人实际的尺寸信息配置。
labelConfidence=置信度
labelConfirmDeleteCount=确认删除 {} 个 {} 吗？
labelConfirmDeleteEle=确认删除以下元素吗？
labelConnect=连接
labelConnectionType=连接类型
labelConnectionTypeGwWS=网关上报
labelContainerCenterRobotCenterOffset=容器中心距机器人中心偏移
labelContainerImage=容器图片
labelContainerInFalconTask=容器运回猎鹰任务
labelContainerName=容器名
labelContainerOutFalconTask=容器运出猎鹰任务
labelContainerOversize=货物尺寸超过机器人底盘
labelContainerOversize_tip=如叉车叉取托盘或顶升车顶料架，载货后，货物超过机器人底盘。​
labelContainerType=容器类型
labelContainerView=容器预览
labelContourPolygon=外轮廓坐标
labelCreateRobot=新增机器人
labelCreated=已创建
labelCurrentMap=当前机器人组的地图
labelCurrentPoint=当前站点
labelCurrentStep=当前步骤
labelCurrentTransportOrder=当前运单
labelCustomQUery=自定义查询
labelCustomScript=定制脚本
labelDataPoint=数据点
labelDevice=设备
labelDeviceName=设备名称
labelDiffCoordValue=坐标差值
labelDirectOrderFlow=直接运单时间轴
labelDisableMapElement=停用地图元素
labelDispatchInterval=派单周期（毫秒）
labelDisplayMapSet=显示设置
labelDisplayMapSetTip=自定义地图样式。
labelDoor=门
labelDoorNum=电梯门数量
labelDropGoodsLoc=放货位置
labelEditRobotGroup=编辑机器人组
labelElementDisplay=元素显示
labelEmulateHaiRouRobotCount=仿真海柔机器人个数
labelEnableInPlaceWait=限制接单范围
labelEnableMapElement=启用地图元素
labelEnableRandomOrder=启用随机发单
labelEnableRbk35=启用 3.5.x 版本
labelEndNum=结束编号
labelEndPoint=终点
labelEnterDoorPath=进门路径
labelExample=示例
labelExcuteRobot=执行机器人
labelExcuteStatus=执行状态
labelExecTime=执行耗时
labelExecutionReject=执行拒绝原因
labelExitDoorPath=出门路径
labelExpand=扩展
labelExportOrderSnapshoot=导出运单快照
labelExportTime=导出时刻
labelFailed=失败
labelFaultReason=故障原因
labelFeatCode=功能码
labelFieldTab=字段标签
labelFilteredCondition=筛选条件
labelFinish=完成
labelFleet=车队管理
labelFleetDev=调度开发
labelFleetSceneView=调度场景
labelFleetStepStatusPending=待执行
labelFleetToRobot=调度连机器人
labelFloorCode=楼层编码
labelFloorName=楼层名
labelFloorNum=工作楼层数量
labelFloorOrder=楼层顺序
labelForLoad=在此步取货
labelForUnload=在此步卸货
labelForkUpheight=货叉的举升高度(m)
labelFrontView=正视图
labelFuncCode=功能码
labelGoToExec=去执行
labelGoodsAbility=载货能力
labelGwAuthId=网关用户 ID
labelGwAuthSecret=网关登录密钥
labelHaiKangCarControl=启用海康单车控制
labelHaiRouCarControl=启用海柔单车控制
labelHaiRouCarDisableTrans=海柔单车通讯禁用 SSL
labelHandleTime=处理耗时
labelHelp=帮助
labelIPAddress=IP 地址
labelIdlerSafeHeight=空载行走高度
labelImportDesc=导入说明
labelInPath=所在路径
labelIndex=位置索引
labelInitialState=初始态
labelIpPlaceholder=IPv4，例如 192.168.192.100
labelJinBo=金博
labelKeepAllocation=保持分配关系
labelLeg=腿
labelLegHeight=腿高度
labelLegLength=腿形状长度
labelLegOuterLength=腿外长度
labelLegOuterWidth=腿外宽度
labelLegSize=腿尺寸
labelLegWidth=腿形状宽度
labelLift=电梯
labelLoadedMaxBackSpeed=最大后退速度（载货）
labelLoadedMaxRotSpeed=最大旋转速度（载货）
labelLoadedMaxSpeed=最大前进速度（载货）
labelLocInfo=位置信息
labelMapAreaPrefix=切换区域，当前：{}
labelMapCount=地图数量
labelMapLoading=地图载入中
labelMapStatusBar=地图状态栏
labelMapText=文本
labelMatch=匹配
labelMaxBackSpeed=最大后退速度（空载）
labelMaxLength=最大长度
labelMaxNumLength=数字位数
labelMaxRotSpeed=最大旋转速度（空载）
labelMaxSpeed=最大前进速度（空载）
labelMd5=当前地图 MD5
labelMeasureRuler=测量尺
labelMeasuringResult=测量结果
labelMerged=合并
labelMinChargeTime=最小充电时间
labelMode=模式
labelMoveForkHeight=载货行走时，货叉的高度(m)
labelMulti=多个
labelNextStepSameOrder=强制要求下一步必须相同运单
labelNoAnyScene=没有任何场景，请先创建或启用一个
labelNoImage=暂未上传图片
labelNotGive=待分配
labelNotMatch=不匹配
labelNotOrder=无运单
labelNotShowPointOccupyAndRequest=不显示点位占用和申请
labelNotUsed=不使用
labelNowStatus=显示实时路况
labelNumCount=编号位数
labelNumDigital=数字精度
labelOffline=离线
labelOffset=偏移量
labelOkText=确认文字
labelOne=一个
labelOnline=在线
labelOnlyOrderOk=仅未封口
labelOpInPlace=原地执行
labelOpenFunName=呼梯函数名
labelOpenPre=提前开门
labelOpenPreDist=提前开门距离
labelOpenedStatus=开门到位信号
labelOrderAllocationReject=运单无法被分派的原因
labelOrderDetail=运单详情
labelOrderExecutionReject=运单无法被执行的原因
labelOrderNum=运单数量
labelOrderReplay=运单重放
labelOrderSnapshootRemark=备注：可以填写本次导出的目的或说明，下次打开此快照时，会显示出来。
labelOrderStatusAllocated=已分派
labelOrderStatusCancelled=已取消
labelOrderStatusDone=已完成
labelOrderStatusExecuting=执行中
labelOrderStatusPending=待执行
labelOrderStatusToBeAllocated=待分派
labelOrderWithdrawnCount=重派次数
labelOrientation=朝向
labelOtherLift=在此区域停靠的其他电梯：
labelOuterLength=容器外长度
labelOuterSize=外轮廓尺寸
labelOuterWidth=容器外宽度
labelPanelTitle=面板标题
labelParamObjectType_RobotGroup=机器人组
labelParamObjectType_RobotName=机器人
labelParamObjectType_RobotScene=机器人场景
labelParamObjectType_TomBlockId=调度（CORE）块 ID
labelParamObjectType_TomOrderId=调度（CORE）运单号
labelParameter=参数
labelPath=路径
labelPathDir=路径正走倒走标识
labelPause=暂停
labelPending=挂起
labelPermitOrder=允许接单
labelPlusOne_tip=用于料箱车，开启以后，允许货叉用于临时背篓。​
labelPoint=点位
labelPointName=点位名称
labelPointOrBin=点位或库位
labelPortNum=端口号
labelPosition=位置
labelPreviewLift=预览
labelPriorityLevel=优先级别
labelPulledMap=选择要拉取的机器人地图
labelPulse=脉冲边缘触发
labelPulseHighInterval=每个脉冲高电平时间（毫秒）
labelPulseLowInterval=每个脉冲低电平时间（毫秒）
labelQueryFail=查询失败
labelRackChannel=巷道
labelRadius=半径
labelRandomModeBzLine=按业务线随机发单
labelRandomModeGroup=按机器人组随机发单​
labelRandomModeSimple=简单随机发单​
labelRandomOrderEdit=编辑随机发单
labelRandomOrderTitle=配置随机发单
labelRandomOrders=随机发单
labelRecAndForkLoad=识别并叉取
labelRecConfig=识别并叉取的配置
labelRecName=识别文件的名称
labelRecognize=识别
labelRecognizeFork=识别并叉取
labelRefreshRate=刷新频率
labelRejectOrderReason=不接单原因
labelRejectStepReason=不执行单步原因
labelRelocInit=重定位初始化
labelRelocSuccess=重定位成功
labelRenderedType=显示模式选择
labelReplaying=运单重放中
labelReportFunName=询梯函数名
labelRobotBlocked=被阻挡
labelRobotCount=机器人数
labelRobotDisplayCard=显示机器人卡片
labelRobotDisplayCardPos=机器人卡片显示位置
labelRobotDisplayName=只显示名字
labelRobotDisplayNo=不显示
labelRobotDisplayType=机器人名称和状态显示方式
labelRobotExecutingOrder=当前执行
labelRobotExtTaskStatus=扩展任务状态
labelRobotFetchTime=状态获取时间
labelRobotGiveTime=机器人分配时间
labelRobotGroup=机器人组
labelRobotGroupCount=机器人组数
labelRobotGroupName=机器人组名称
labelRobotHead=机器人头部（+x 轴）
labelRobotImage=机器人图片
labelRobotIp=机器人地址（IP）
labelRobotIp_tip=填机器人 IP 地址，仅当“调度连机器人”时需要填写。​
labelRobotLoads=载货
labelRobotLock=控制权
labelRobotLockedSiteIds=当前占用的点位
labelRobotMaxLoads=最大载货数
labelRobotMaxLoads_tip=主要用于料箱车，其他车一般是 1。例如料箱车有 3 个背篓，则填 3；如果启用 N+1，填 4。允许小于背篓数，比如虽然有 6 个背篓，但只想用 4 个，就填 4。​
labelRobotModalMock=机器人模式：仿真
labelRobotModelCollision=显示碰撞模型
labelRobotModelIcon=根据机器人类型显示图标
labelRobotModelStyle=机器人模型样式
labelRobotName=机器人名称
labelRobotNamePrefix=机器人名称前缀
labelRobotNextOrder=下一执行
labelRobotOffDutyNo=可接单
labelRobotOpacity=机器人不透明度
labelRobotPendingSiteIds=申请中的点位
labelRobotPlanPath=机器人规划路径
labelRobotPortStart=机器人起始端口
labelRobotPortStart_tip=真机器人请忽略，主要用于连接仿真机器人。
labelRobotPosB=机器人下方
labelRobotPosTr=机器人右上方
labelRobotPrefix=机器人:
labelRobotSpaceResources=机器人预定的空间资源
labelRobotTail=机器人尾部（-x 轴）
labelRobotTargetPoint=机器人目标点
labelRobotTask=机器人任务
labelRobotTaskStatus=任务状态
labelRobotToFleet=机器人连调度
labelRobotWidth=机器人宽度（y 轴）
labelRotateRadius=旋转半径
labelRuleDesc_1=使用英文符号，不要有空格。
labelRuleDesc_2=至少要有一个步骤。步骤必须有点位/库位和动作。
labelRuleDesc_3=一个运单至多一次取放货。
labelRuleDesc_3_1=取货动作/binTask必须包含 load，放货必须包含 unload。
labelRuleDesc_4=指令结构：
labelRuleDesc_4_1=前：指定的机器人名。
labelRuleDesc_4_2=前：指定仿真机器人出生点。
labelRuleDesc_4_3=后：加数字表示优先级。
labelRuleDesc_4_4=后：加动作表示指定 binTask。
labelRuleDesc_4_5=后：加数字表示指定放货容器角度。
labelRuleDesc_4_6=前：容器类型，如 Container-type-1$。如果指定了容器类型，此运单必须要有 load、unload。对于所有容器尺寸超过底盘的（如顶升车、叉车），都需要指定容器类型。
labelRuleDesc_4_7=如要指定容器编号，容器类型与容器编号采用英文冒号分隔，如 Container-type-1:container-1$
labelRuleDesc_5=顺序：指定机器人@容器类型:容器编号$仿真机器人出生点%目标点:*指定binTask->目标点:动作^指定放货角度#优先级
labelRuleIntro=规则说明
labelRunScene=运行场景
labelRunning=正在执行
labelRunningStatus=运行情况
labelSSlOn=SSL/TSL 加密
labelSafeDist=安全距离
labelSafeDistHead=安全距离（前）
labelSafeDistLeft=安全距离（左）
labelSafeDistRight=安全距离（右）
labelSafeDistTail=安全距离（后）
labelSafeDist_tip=目前主要用于机器人之间的安全距离。用于增大机器人的碰撞体积。​
labelSalverNotRotate=货物能旋转
labelSalverNotRotate_tip=顶升机构支持转动的车型才开启，叉车不可开启！
labelScene=场景：
labelSceneId=场景 ID
labelSceneLabel=场景
labelScriptName=脚本名
labelSearch=搜索
labelSearchMap=搜索地图元素
labelSearchMapTip=每种元素显示前 3 条结果，请输入具体的元素名称获取精确匹配。
labelSearchTip=搜索 ctrl + F
labelSeerSheduleCore=仙工调度内核
labelSeerSheduleID=仙工调度 ID
labelSelectExportRange=选择导出范围
labelSelectListRange=选定范围
labelSelectSMPoint=切换地图点（SM 点）
labelSendOrderBzTip=起点和终点需要手动输入库位/点位标签，多个标签以逗号分隔
labelSendOrderDetail=发单详情
labelSendOrderHelpTitle=简单发单在线帮助
labelSetPriorityForOrder=为 {} 个运单设置优先级
labelSfSafeHeight=货叉行走高度
labelSfSafeHeightOnMove=货叉边走边调整高度
labelSheduleWebSite=调度网址
labelShowAsSwitch=显示为开关
labelShowMode=显示模式
labelSmSel=选择 SM 点
labelSpeedConfig=机器人速度配置
labelSpeedConfig_tip=目前主要给仿真机器人参考；真机器人会优先获取机器人的配置，获取不到才会取此配置。
labelSplitScreen=分屏
labelStartNum=开始编号
labelStartPoint=起点
labelStartReplay=开始重放
labelStartSoonOrder=启动时立即接单
labelStatusFilter=状态过滤
labelStatusFiltered=状态筛选
labelStepFixed=步骤固定
labelStepProgress=步骤进度
labelStepTimeInterval=仿真每步时间间隔（毫秒）
labelStop=终止
labelStopChar=停
labelStopReplay=停止重放
labelStopRobotsIfDoorException=过门故障是否急停
labelSui=人工处理
labelSummaryFieldList=摘要字段列表
labelSummaryFormatCode=摘要格式化代码
labelTakeGoodsLoc=取货位置
labelTimeline=时间轴
labelToBeConfirmed=待确认
labelTodayOdo=今日里程
labelTools=工具栏
labelTransGoods=载货情况
labelTransportOrderNum=运单数：{}
labelTransportOrders=运单
labelTransportOrdersList=运单列表
labelUnableRun=无法执行
labelUnkonwNameBtn=未命名按钮
labelUnkonwNameField=未命名字段
labelUploadImage=上传图片
labelUpperHeight=上高度
labelValueTransCode=值转换代码
labelWait=等待
labelWithdrawOrderAllowed=允许重分派
labelWmsPort=库口
labelWorkArea=工作区域
labelWorkIn=电梯在该区域工作
labelWriteCmd=写指令
labelZoomFitTip=展示完整地图
labelZoomInTip=放大地图：滚轮↑
labelZoomOutTip=缩小地图：滚轮↓
lableDisable=禁用
lalRobotOffDuty=不接单
lastOrder=上一单
linkBtnClearAlarm=清除告警
lookProperty=查看属性
mapActionPoint=动作点
mapAdvancedArea=高级区域
mapAngle=角度
mapArea=特区
mapAreaList=区域列表
mapAreaProperty=特区属性
mapBlockArea=调度互斥区
mapBtnAddArea=添加区域
mapBtnSelect=选择
mapCanStop=可停靠
mapChargePoint=充电点
mapDIArea=DI区域
mapDOArea=DO区域
mapEndSelect=结束选择
mapFreeNav=自由导航
mapGoBack=倒走
mapGoDual=双向
mapGoForward=正走
mapHeight=高
mapHomeRegion=Home区域站点
mapImporting=正在导入请稍后...
mapInfraredGuidance=红外导航
mapIngnore=忽略角度
mapLabelCarbody=车体
mapLabelFixedRight=固定在右侧
mapLabelPathNav=路径导航
mapLabelSteer=舵轮
mapLocConfigArea=定位配置区域
mapMagstripeGuidance=磁条引导
mapNormalPoint=普通点
mapParkPoint=停靠点
mapPathProperty=路径属性
mapPointProperty=站点属性
mapPointType=站点类型
mapQRcodeNav=二维码导航
mapRadian=弧度
mapReflectorArea=反光板区域
mapSelectOneFromVariable=或者，从现有值中选择一个：
mapSelectRobotFirst=请先选择机器人
mapSelectRobotToControl=请先选择要控制的机器人
mapSelectTypeAll=全部
mapSelectTypeEdge=路径
mapSelectTypeSite=站点
mapSelectTypeZone=区块
mapSendCancelPathNav=取消路径导航请求已发送
mapSendPausePathNav=暂停路径导航请求已发送
mapSendResumePathNav=恢复路径导航请求已发送
mapSetNewValue=设置一个新的值：
mapSite=库位
mapSwitchMap=切换地图点
mapTipImportLandmark=每行一个站点。X、Y 和角度用逗号或空格分隔。角度可以不填。X、Y 单位毫米。角度单位度。
mapTipMaxValue=最大值为
mapTipMinValue=最小值为
mapTipSelectArea=点击选择要显示的区域：
mapWidth=宽
more=更多功能
navTo=导航到 {}
noGpsInfo=无定位信息
op=动作：
orderHasOk=已封口
orderNotOk=未封口
pageRobotAppIndex=机器人应用管理
pageSmapViewer=Smap 查看器
peopleStop=手动终止
retryFailed=失败重试
selectArea=选择区域:
selectOrMove=选择/移动
selectScene=选择场景:
selectSceneAndArea=选择地图场景和区域
siteOp=库位动作：
start=起点：
straightPath=直线
tipAreaTooSmall=区域过小
tipBatchEdgeResult=所选站点识别为 {} 行，分别有 {} 列
tipCancelNotDisableElement=可取消勾选不停用的元素
tipCancelNotEnableElement=可取消勾选不启用的元素
tipCheckSendOrderFormat=请检查格式
tipClickPoint=点击目标站点
tipConfirmDisableElement=确定停用以下元素吗？
tipConfirmEnableElement=确定启用以下元素吗？
tipContourPolygon=指相对于容器中心点的坐标，选取左上角作为起点，按顺时针的顺序填写点位坐标
tipCopyFailedSelecetOnePointOrArea=拷贝失败：请至少选择一个站点或特区
tipCopyFirstToPaste=请先拷贝再粘贴
tipCopyOrder=只能复制业务单
tipCopySuccessByPointAndArea=拷贝成功：{}个站点、{}个区块
tipDeleteDoor=确定删除门吗?
tipDeleteLift=确定删除电梯吗?
tipEmulation=自动创建仿真机器人、门、电梯并修改连接方式。
tipEnsureDisConnectAllPathLink=确定要断开与所选站点相连的所有路径吗？
tipEnsureRobotToPointAndSceneChangedNeedPushMap=确定要让机器人 {} 路径导航到站点 {}  吗？\n注意场景修改过后可能需要再推送地图。
tipExportOrderSuccess=成功导出 {} 条运单，请下载
tipFailedSelectRetry=选择失败，请重新选择
tipImportDesc=请导入 orders.json 文件，该文件可通过"导出快照"生成。
tipInPath=支持门经过多个路径；如果是双向路，两条路都要填。
tipInputAreaName=输入区域名称
tipInputRobotNameToAdd=请输入要添加的机器人名。可以输入多个，逗号分隔。
tipInputSceneName=请输入场景名称
tipKeepAllocation=若选择“保持分配关系”，已分派机器人的运单，将分给记录中的原来分派的机器人（通过指定机器人的方式）。注意，场景里得有这些机器人！如果不选择，则运单可以重新分派给其他机器人。
tipKeyPositionInput=请输入关键位置，多个位置逗号分隔
tipKeyPositionIsRequired=当步骤为零时 "关键位置" 是必填项
tipLocInfo=本组信息目前仅用于显示，不必填
tipMapSync=实现机器人地图和场景地图的同步。
tipNoCurSel=当前不可选。
tipNumCountThan_1=开始编号不允许大于结束编号
tipNumCountThan_2=开始编号位数不能大于编号位数
tipNumCountThan_3=结束编号位数不能大于编号位数
tipOneSelectElement=请至少选择一种元素
tipOnlyToRobot=仅针对机器人
tipOrderBlock=运单 {} 块
tipOrderReplay=可在运单列表页中选择要重放的运单，“导出快照”生成重放文件。
tipPathNavReqHasSend=路径导航请求已发送
tipPointUsed=点位“{}”已被电梯“{}”使用，
tipRefresh=已刷新
tipRobotInMap=请输入使用此地图的机器人名称，每行一个
tipRobotNotInArea=机器人不在当前区域
tipScene=可以导入导出 M4 格式的场景，或者导入原有的 RDS CORE 场景。
tipSelectDataInList=请先在列表页至少选择一行数据
tipSelectDoorNo=选择门号
tipSelectedRow=提示：已选中 {} 行
tipTotalBlock=共 {} 块
tipUpdateUsed=被使用的点位可点击对应电梯进行修改。
tipWorkArea_1=1. 每个电梯必须勾选配置两个及以上区域。
tipWorkArea_2=2. 楼层顺序：填写该区域对应的楼层数字，例如加工层 1 区在 1 楼，加工层 2 区在 1.5 楼，加工层 3 区在 2 楼，则填写：1、1.5、2。楼层数字用于计算层差，影响电梯运行成本。
tipWorkArea_3=3. 一个 SM 点只能被一部电梯配置使用。
titleRobotList=机器人列表
totalCountG=共 {} 个
totalStep=共 {} 步
unableFindOrder=找不到运单 {} 。调度={}
unknown=未知

[fleet.tom]
CmdStatusLabels_Failed=故障
CmdStatusLabels_Idle=空闲
CmdStatusLabels_Interrupted=中断
CmdStatusLabels_Moving=执行中
StepStatusCancelled=已取消
StepStatusDone=已完成
StepStatusExecutable=待执行
StepStatusExecuting=执行中
StepStatusSkipped=已跳过
StepStatusWaiting=等待中
StepStatusWithdrawn=已取消
btnCompleteTransportOrder=封口
btnTerminateTransportOrder=终止运单
confirmCompleteTransportOrder=确定要封口以下运单吗？{}
confirmTerminateTransportOrder=确定要终止以下运单吗？{}
labelCoreScheduler=调度 core
labelOtherOrder=外部单号
labelPriorityHigh=加急
labelPriorityNormal=普通
labelPriorityUrgent=紧急
labelPushFail=推送失败
labelPushOk=推送完成
labelPushing=推送中...
labelSelectFloorPlease=请选择楼层
labelTheTomServer=调度：
labelTomBlocks=块
labelTomOrder=调度（CORE）运单
labelTomOrderComplete=封口
laeblSetPriority=设置优先级
tipPushComplete=推送完成，匹配状态已更新
tipSeePushProgress=关闭了弹窗将无法看到推送进度，是否确认关闭？
tipSummaryPushComplete=推送完成，{} 个成功，{} 个失败
tipSummaryPushing=进行中：共推送 {} 个机器人，{} 个成功，{} 个失败，{} 个进行中

[fleet.mars]
labelLight=光通讯
labelLightTransDispatch=光通讯派单
labelLightVersion=光通讯版本

[fleet.ndc]
labelEnableNdc=启用 NDC 调度
labelNDC=NDC
labelNDCId=NDC IP
labelNdcPort=NDC 端口

[fleet.single]
addScene=添加场景
agvConfig=机器人应用配置
btnContaol=遥控
btnToDisplayZoomIn=放大显示
btnToDisplayZoomNo=恢复默认
btnToDisplayZoomOut=缩小显示
btnToEnterFullscreen=全屏显示
btnToExitFullscreen=退出全屏
cancelNav=取消导航
cancelSoftStop=取消软急停
charging=充电中
clearAgvAlarm=清除机器人告警
confirmClearAgvSite=确定要清空机器人身上的库位 {} 吗？
confirmPos=确认定位
currentHeight=当前高度：
currentMap=当前地图
currentPosition=当前位置
dateNow=当前时刻
deleteScene=删除场景
emergencyStop=急停
enableLightOrder=启用光通讯派单
forkHeight=货叉高度
functionNotOpen=功能未开放
getControl=获取控制权
gwOrder=单车运单
hasControl=有控制权
hasGoods=有货
heightFork=堆高叉车
jackLoad=顶升
labelAllowCharge=允许充电
labelBoxToFork=背篓 → 货叉
labelConfimMoveToThis=确定将货物从货叉移动到此位置吗?
labelConfirmMoveToFork=确定将货物从此位置移动到货叉吗?
labelConfirmRobotCancelOrder=确定要取消机器人 {} 当前运单 {} 吗？
labelContainerDirection=容器角度
labelContainerEntryDir=进入路径时容器方向要求
labelContainerLineMustAhead=窄边通行
labelContainerRotateAllowed=换向点
labelCreateQuickOneMonitor=创建单车监控
labelCurveType=曲线类型
labelDealLockNoPass=避让不可通过
labelDisplaySettings=显示调整
labelFastSpeed=高速
labelFaultInfo=故障信息
labelFirstOpenSingle=请先到系统配置中开启单车应用模式
labelForkToBox=货叉 → 背篓
labelForkView=货叉画面
labelHistoryRecord=历史记录
labelHome=首页
labelHorizonSpeed=横移速度
labelLinkedPathAsJointResource=相连路径一起申请资源
labelMonitor=监控
labelMoreLogin=更多登录方式
labelMoreOp=更多操作
labelMove=移动
labelMoveDirection=正走倒走
labelNav=导航
labelNoRobotConnect=暂无机器人连接
labelNoRotate=不允许旋转
labelNormalSpeed=中速
labelOrg=机构
labelQuickOnePage=单车管理
labelRemoteControl=遥控
labelRobotRunTime=机器人运行时间
labelRobtAppLight=光通讯调度
labelRobtAppRachel=三代调度
labelRobtAppSingle=单车应用
labelRobtAppTom=二代调度（CORE）
labelSceneIsNotSingle=当前场景不是单车应用
labelSetGoods=置为有货
labelSingleAppMode=单车应用模式
labelSingleAppModeOpen=开启单车应用模式
labelSingleIsNot=当前不是单车应用模式，如需切换到单车应用模式，请到《系统配置-单车应用》页面修改配置
labelSingleNoRobot=当前无机器人连接，请检查机器人是否开机，或到《机器人应用管理》页面检查配置
labelSingleNoScene=当前不是单车应用场景，如需切换单车应用场景，请到《机器人应用管理》页面修改配置
labelSingleSystem=M4 单车应用管理系统
labelSlowSpeed=低速
labelSpeedSetting=速度设置
labelSpin=随动
labelTapToControl=点击遥控来手动控车
labelUseDefaultLayout=使用默认布局
labelWelcome=欢迎登录
laeblSetEmpty=置为无货
lastGWOrder=上一单车运单
lebelWSpeed=角速度
light=光通讯调度
navNoPassPoint=导航尚未经过的站点
navPassPoint=导航已经经过的站点
navStatus=导航状态
navTargetPoint=导航目标点
navToAnyPoint=自由导航到任意点
navToLandMark=导航到站点
navType=导航类型
noGoods=无货
noNav=没有导航
noPosInfo=无定位信息
noRobot=无机器人
note=备注
nowGWOrder=当前单车运单
pasuseNav=暂停导航
pathNavToLandMark=路径导航到站点
pausePathNav=暂停路径导航
pleaseGetControl=请获取控制权
pleaseSelectToPoint=请选择要去的站点
pleaseTapToControl=点击获取控制权
posStatus=定位状态
putDpwn=放下
putGoods=放货
putGoodsToAgvSite=将货物放到机器人身上的库位
putUp=放上
rachel=三代调度
releaseControl=释放控制权
resumeNav=继续导航
resumePathNav=恢复路径导航
robotGoodsStatus=机器人身上货物状态
rotationSpeed=转速
sceneCantEmpty=场景名称不能为空
sceneInputAddress=场景 {} 请填写调度地址
sceneModel=场景模式
sceneName=场景名称
sceneNameCantRepeat=场景名称不能重复
selectDate=请选择日期
selectDateTime=请选择日期时间
selectToLandMark=请选择要去的站点
singlApp=单车应用
singleAddStep=添加步骤
singleBgColor=背景颜色
singleBtnTheme=按钮主题
singleClear=清错
singleComponentSet=组件
singleCurrent=当前
singleEndPoint=终点
singleExpressiong=表达式
singleForkSwitchToAuto=请将叉车转换为自动模式
singleGetControl=获取控制权
singleInstructConfig=机构配置
singleIp=单车 IP 地址
singleLabelDefault=默认值
singleLabelTpye=类型
singleMethod=方法
singleNextMargin=与下一项的间距
singleNextPoint=下一个站点
singleNoPassPoint=未经过的站点
singleNoSetContent=未设置内容
singleNoWrite=未填
singleOrder=运单
singleOrderCreate=单车运单创建
singleParam=operation参数
singlePassPoint=已经过的站点
singleReleaseControl=释放控制权
singleSetSuccess=设置成功
singleSpeed=速度
singleStartPoint=起点
singleTagContetn=标签内容
singleTarget=目标点
singleTextColor=文字颜色
singleToSite=导航到站点
singleUnit=单位
singleVariable=变量
singlebtnTag=按钮标签
singletextType=文本类型
speed=速度
stop=停止
suitableTom=兼容二代调度 CORE
takeDown=取下
takeGoods=取货
tapOkBtnThenSettingOk=点击确认按钮后，设置生效
toTargetHeight=升降到指定高度
tom=二代调度（CORE）
tomAlarm=调度告警
tomIp=调度 CORE HTTP 地址
topUp=顶起
transFork=搬运叉车
translate2D=平动转动
unableGetStatusLook=无法获取状态，查看
unableTakeOrderNoTakeResource=不可接单不占资源
upgradeTime=更新时间

[fleet.mock]
btnAddAction=添加动作
btnAutoMode=自动模式
btnCancelMockRobotNavTask=取消路径导航
btnChangeRobotInitPointsRandomly=随机初始点位
btnEmc=急停
btnEmcClear=解除急停
btnExportConfig=导出配置
btnExportMockRobotsSnapshots=导出机器人状态
btnImportConfig=导入配置
btnImportMockRobotsSnapshots=导入机器人状态
btnManualMode=手工模式
btnMockBattery=仿真电量
btnMockChargeF=不耗电/充电
btnMockChargeT=仿真耗电/充电
btnMockRobotReconnect=仿真机器人重连服务器
btnPauseMock=暂停仿真
btnPauseMockRobotNavTask=暂路路径导航
btnPositionPose=位姿
btnRemoveMockRobots=删除机器人
btnResetMock=一键重置
btnResumeMock=继续仿真
btnResumeMockRobotNavTask=继续路径导航
btnSoftEmc=软急停
btnSoftEmcClear=解除软急停
confirmToCancelRobotNavTask=确定要取消机器人当前路径导航任务吗？
confirmToResetMock=确定要一键重置仿真吗？请谨慎操作。
errorSelectAnyRobot=请至少选择一个机器人
labelActionMockType=动作仿真模式
labelActionName=动作名称
labelAlarmCode=告警码
labelAlarmLevel=告警级别
labelAlarmMsg=告警消息
labelCancelAfterEmc=急停后取消机器人任务
labelCostTime=耗时（秒）
labelCurrentTheta=当前朝向
labelCurrentX=当前位置 X
labelCurrentY=当前位置 Y
labelDefaultActionCostTime=默认动作耗时（秒）
labelFleetTcpServerIp=调度 TCP 服务器 IP
labelFleetTcpServerPort=调度 TCP 服务器端口
labelInitBattery=出生电量（0~100）（%）
labelInitMap=出生地图
labelInitPoint=出生点位
labelInitPositionX=出生位置坐标 X
labelInitPositionY=出生位置坐标 Y
labelMaps=地图列表
labelMaxBackVelocity=最大后退速度
labelMaxRotateVelocity=最大旋转速度
labelMaxVelocity=最大前进速度
labelMock=仿真(发给 NdcMockServer)
labelMockBattery=电量（充电/耗电）配置
labelMockChargeNo=不耗电/充电
labelMockChargeOk=仿真耗电/充电
labelMockChargePeriod=充电时，电量每增加 1% 的时间间隔
labelMockConsumePeriod=耗电时，电量每减少 1% 的时间间隔
labelMockPaused=仿真已暂停
labelMockRobotAlarm=告警
labelMockRobotConfig=仿真机器人配置
labelMockRobotContainerNum=机器人背篓数
labelMockRobotIp=机器人 IP，显示用
labelMockRobotKeepInArm=料箱机器人 N+1 模式
labelMockRobotRecord=仿真机器人状态
labelMockRobots=仿真机器人
labelMockRunning=仿真运行中
labelMockSelfBins=机器人身上库位
labelMockSelfBins_tip=修改后的背篓信息不会被同步到调度场景的机器人中，但会用于背篓数据校验！
labelMockSpeedFactor=仿真倍率
labelMockTcpServerPort=机器人 TCP 服务起始端口
labelRobotNameEnd=机器人编号结束
labelRobotNameStart=机器人编号开始
labelRobotNameWidth=机器人编号宽度
labelSelfBinDesc=描述
labelSelfBinGoodsId=容器
labelSelfBinHasGoods=有货
labelSelfBinIdx=机器人背篓位置
labelSetMasterAfterEmc=急停后 RBK 获取控制权
labelUnsetMasterAfterUnClearEmc=解除急停后，RBK 释放控制权
pageAddManyMockRobots=批量添加机器人
pageAddOneMockRobot=添加单个机器人
pageConfigActionsCosts=配置动作耗时
pageCopyMockRobots=复制机器人
pageEditManyMockRobotRecords=修改机器人状态
pageEditManyMockRobots=修改机器人配置
pageEditMockRobotConfig=修改机器人配置
pageEditMockRobotRecord=修改机器人状态
pageEditMockRobotsMaps=修改机器人地图
pageEditRobotAlarms=修改机器人告警
pageMockIndex=仿真中心
pageRenameMockRobots=批量重命名
pageViewMockRobot=查看仿真机器人
tipChangeMockSpeedFactor=请输入仿真倍率：大于零的数字，可以是小数。2 表示 2 倍率。
tipRenameMockRobots=重命名 {} 个仿真机器人

[fleet.meta]
json-label_RobotOrderUiReport_autoOrder=自动单
json-label_RobotOrderUiReport_bins=机器人身上库位
json-label_RobotOrderUiReport_chargingOrderDoneOn=充电完成时间
json-label_RobotOrderUiReport_cmdStatus=执行运单的状态
json-label_RobotOrderUiReport_cmdStatus_optionBill_Failed=失败
json-label_RobotOrderUiReport_cmdStatus_optionBill_Idle=空闲
json-label_RobotOrderUiReport_cmdStatus_optionBill_Interrupted=打断
json-label_RobotOrderUiReport_cmdStatus_optionBill_Moving=移动中
json-label_RobotOrderUiReport_containerBlockedBy=阻挡当前机器人的其他货架列表
json-label_RobotOrderUiReport_createdBy=创建人
json-label_RobotOrderUiReport_createdOn=创建时间
json-label_RobotOrderUiReport_executingSelected=执行中的运单步骤
json-label_RobotOrderUiReport_extra=extra
json-label_RobotOrderUiReport_faultMsg=失败信息
json-label_RobotOrderUiReport_id=ID
json-label_RobotOrderUiReport_idleFrom=开始空闲时间
json-label_RobotOrderUiReport_modifiedBy=最后修改人
json-label_RobotOrderUiReport_modifiedOn=最后修改时间
json-label_RobotOrderUiReport_moveActions=移动指令
json-label_RobotOrderUiReport_nextSelected=要执行的运单步骤
json-label_RobotOrderUiReport_offDuty=不接单
json-label_RobotOrderUiReport_orderReject=运单拒绝原因
json-label_RobotOrderUiReport_orders=运单号
json-label_RobotOrderUiReport_pendingTrafficTask=需要交管规划执行的任务
json-label_RobotOrderUiReport_recentReq3066s=最近 3 条 3066 指令
json-label_RobotOrderUiReport_reportingChargingOn=充电开始时间
json-label_RobotOrderUiReport_robotBlockedBy=阻挡当前机器人的其他机器人列表
json-label_RobotOrderUiReport_spaceResources=资源占用情况
json-label_RobotOrderUiReport_stepReject=步骤拒绝原因
json-label_RobotOrderUiReport_trafficReady=交管已准备好
json-label_RobotOrderUiReport_travelledPointNames=已经经过的点位名称列表
json-label_RobotOrderUiReport_unTravelPointNames=未经过的点位名称列表
json-label_RobotOrderUiReport_version=修订版本
json-label_RobotOrderUiReport_withBzOrder=有业务单
json-label_RobotSelfReportMain_alarms=告警
json-label_RobotSelfReportMain_battery=电池电量
json-label_RobotSelfReportMain_blocked=是否被阻挡
json-label_RobotSelfReportMain_charging=充电中
json-label_RobotSelfReportMain_confidence=定位置信度
json-label_RobotSelfReportMain_controller=控制权所有者名称
json-label_RobotSelfReportMain_createdBy=创建人
json-label_RobotSelfReportMain_createdOn=创建时间
json-label_RobotSelfReportMain_currentMap=当前地图名
json-label_RobotSelfReportMain_currentMapMd5=当前地图 MD5
json-label_RobotSelfReportMain_currentPoint=当前站点名称
json-label_RobotSelfReportMain_direction=机器人车头朝向（弧度）
json-label_RobotSelfReportMain_emergency=急停按下
json-label_RobotSelfReportMain_id=ID
json-label_RobotSelfReportMain_isControlled=机器人控制权是否被抢占
json-label_RobotSelfReportMain_loadRelations=机器人载货情况
json-label_RobotSelfReportMain_lsPosition=末次上报位置
json-label_RobotSelfReportMain_modifiedBy=最后修改人
json-label_RobotSelfReportMain_modifiedOn=最后修改时间
json-label_RobotSelfReportMain_moveStatusInfo=机器人导航信息
json-label_RobotSelfReportMain_relocStatus=重定位状态
json-label_RobotSelfReportMain_relocStatusLabel=重定位状态描述
json-label_RobotSelfReportMain_relocStatus__optionBill_Init=重定位初始化
json-label_RobotSelfReportMain_relocStatus__optionBill_Loading=地图载入中
json-label_RobotSelfReportMain_relocStatus__optionBill_Relocing=正在重定位
json-label_RobotSelfReportMain_relocStatus__optionBill_Success=重定位成功
json-label_RobotSelfReportMain_rotateVelocity=机器人角速度
json-label_RobotSelfReportMain_timestamp=获取机器人位置的时间
json-label_RobotSelfReportMain_todayOdo=今日里程
json-label_RobotSelfReportMain_velocity=机器人直线速度
json-label_RobotSelfReportMain_version=修订版本
json-label_RobotSelfReportMain_vx=在机器人坐标系的 x 方向实际的速度
json-label_RobotSelfReport_createdBy=创建人
json-label_RobotSelfReport_createdOn=创建时间
json-label_RobotSelfReport_error=是否有错
json-label_RobotSelfReport_errorMsg=错误原因
json-label_RobotSelfReport_id=ID
json-label_RobotSelfReport_main=主要字段
json-label_RobotSelfReport_modifiedBy=最后修改人
json-label_RobotSelfReport_modifiedOn=最后修改时间
json-label_RobotSelfReport_rawReport=原始报文
json-label_RobotSelfReport_stand=机器人当前位置
json-label_RobotSelfReport_timestamp=获取机器人报告的时间
json-label_RobotSelfReport_version=修订版本
json-label_RobotStand_areaId=所在区域 id
json-label_RobotStand_areaName=所在区域名
json-label_RobotStand_closePaths=距离机器人点位最近的路径集
json-label_RobotStand_collisionShape=碰撞框，注意是世界坐标系
json-label_RobotStand_createdBy=创建人
json-label_RobotStand_createdOn=创建时间
json-label_RobotStand_id=ID
json-label_RobotStand_mapName=当前地图
json-label_RobotStand_modifiedBy=最后修改人
json-label_RobotStand_modifiedOn=最后修改时间
json-label_RobotStand_pointName=当前点位名称
json-label_RobotStand_rotateVelocity=旋转角速度
json-label_RobotStand_theta=朝向
json-label_RobotStand_timestamp=获取机器人位置的时间
json-label_RobotStand_velocity=直线速度
json-label_RobotStand_version=修订版本
json-label_RobotUiReport_collisionModel=机器人碰撞模型（机器人坐标系）
json-label_RobotUiReport_config=机器人的配置
json-label_RobotUiReport_createdBy=创建人
json-label_RobotUiReport_createdOn=创建时间
json-label_RobotUiReport_groupId=机器人组 ID
json-label_RobotUiReport_groupName=机器人组名称
json-label_RobotUiReport_id=ID
json-label_RobotUiReport_isMaster=调度是否能控
json-label_RobotUiReport_lastFetchError=上次报错
json-label_RobotUiReport_modifiedBy=最后修改人
json-label_RobotUiReport_modifiedOn=最后修改时间
json-label_RobotUiReport_offDuty=不接单
json-label_RobotUiReport_online=在线
json-label_RobotUiReport_orderRecord=运单处理相关
json-label_RobotUiReport_robotName=机器人名
json-label_RobotUiReport_selfReport=机器人上报信息
json-label_RobotUiReport_stopAutoConnect=停止自动重连
json-label_RobotUiReport_version=修订版本
json-label_SceneRobot_connectionType=机器人和调度的连接方式
json-label_SceneRobot_connectionType_optionBill_FleetToRobot=调度连机器人
json-label_SceneRobot_connectionType_optionBill_GwWs=网关上报
json-label_SceneRobot_connectionType_optionBill_RobotToFleet=机器人连调度
json-label_SceneRobot_createdBy=创建人
json-label_SceneRobot_createdOn=创建时间
json-label_SceneRobot_disabled=停用
json-label_SceneRobot_groupId=所属组 ID
json-label_SceneRobot_gwAuthId=gw 网关用户ID
json-label_SceneRobot_gwAuthSecret=gw 网关登录秘钥
json-label_SceneRobot_id=ID
json-label_SceneRobot_image=图片
json-label_SceneRobot_modifiedBy=最后修改人
json-label_SceneRobot_modifiedOn=最后修改时间
json-label_SceneRobot_remark=备注
json-label_SceneRobot_robotIp=机器人 IP
json-label_SceneRobot_robotName=机器人名称
json-label_SceneRobot_robotPortStart=机器人起始端口
json-label_SceneRobot_selfBinNum=机器人库位数
json-label_SceneRobot_ssl=海柔：连接使用 SSL 加密
json-label_SceneRobot_tags=标签
json-label_SceneRobot_vendor=厂商
json-label_SceneRobot_version=修订版本

[base.time]
hour=时
minute=分
seconds=秒

[base.time.week]
five=五
four=四
labelFriday=星期五
labelMonday=星期一
labelSaturday=星期六
labelSunday=星期日
labelThursday=星期四
labelTuesday=星期二
labelWednesday=星期三
one=一
seven=日
six=六
three=三
two=二

[base.time.month]
April=四月
August=八月
December=十二月
February=二月
January=一月
July=七月
June=六月
March=三月
May=五月
November=十一月
October=十月
September=九月

[store]
allSiteOverview=全部库位一览
callContainerBack=叫容器回库
callContainerOut=叫容器出库
canNotLargeEndCountNum={} 不能大于结束值的位数
carring=搬运中：
columnCountNum=列位数
confirmToDirectCallContainerFromContainer=确定要将容器运出用于装货并回库吗？ {}
confirmToDirectOutboundFromBin=确定要将库位上的物料直接出库吗？{} 注意这是出库，最终会扣减库存！
confirmToDirectOutboundFromContainer=确定要将容器及其中物料直接出库吗？ {} 注意这是将容器运出，用于装货并回库！
containerShowLines=容器/物料展示行数
depthCountNum=深位度
endPoint=。终点库位：
goodsExistNoConfig=物料 {} 有容器类型未配置
goodsMaxPackMoreThan=物料 {} 最多装几个必须大于 0
goodsNotConfig=物料 {} 未配置
goodsRepeatConfigNot=物料 {} 容器类型不能重复配置
hasTakeGoods=已取货
howManyTypeGoods={} 种物料
inStoreOrder=入库单
includeSite=涉及 {} 个库位：
itHasManyGoods=其中含有 {} 种物料：{}
labelAutoCallEmptyContainerForInStore=自动为入库单叫空容器
labelAutoCallEmptyContainerForInStoreInterval=自动为入库单叫空容器时间间隔（秒）
labelAutoOutStoreDealStore=自动出库处理库存
labelBeforeCallCount=之前已叫数量
labelCall=呼叫
labelCallContainer=呼叫容器
labelCallEmptyContainer=叫空容器
labelCallEmptyContainerForInStore=为入库叫空容器
labelColumnRange=列号范围
labelContainerAndGoods=库位和物料
labelContainerAndSite=库位和容器
labelContainerOutStoreFalconTask=容器出库猎鹰任务
labelCount=盘点
labelCreateRange=创建范围
labelDealTimeIntreval=处理时间间隔（毫秒）
labelDepthRange=深度范围
labelFenOrderConfig=分单据配置
labelFilterOutStoreArea=筛选出库库区
labelFilterStoreMatchField=库存筛选匹配字段
labelFilterStoreStatus=筛选库存状态
labelFromInOrderBringField=从入库单行带出字段
labelFromOutStoreLineToSortLineCopyField=从出库单行到分拣单行拷贝字段
labelGoBack=后移
labelGoForward=前移
labelInStoreCount=入库数量
labelLayerRange=层号范围
labelMakeSiteOtherAllOut=将库位上的其他库存一起出库
labelMaxPackCount=最多装几个
labelMeans=含义
labelMixDropFilterField=混放筛选字段
labelMoreOutMore=有多少出多少
labelMustNotInt={} 必须是整数
labelNoEditDesc=如果只有一个排/列/层/深（排/列/层/深编号开始与编号结束一致），可以停用对应命名格式来简化库位编号。如线边只有两个库位，在命名格式中停用排、层，给列加前缀 XB-，库位编号将命名为 XB-01、XB-02。
labelNotGenerateBackStore=不生成回库运单
labelNotGenerateOutStore=不生成出库运单
labelOutPartResumeUntilhasStore=先出部分，有库存了继续出
labelOutStore=出库
labelOutStoreArea=出库区
labelOutStoreConfig=出库单配置
labelOutStoreDealTimeInterval=出库处理时间间隔（毫秒）
labelOutStoreOrdertity=出库单业务对象
labelOutboundOrderToContainerTransportFields=从出库单头到容器搬运单拷贝字段
labelPeoplePass=人工放行
labelPointContainerCall=指定容器呼叫
labelPreview=预览效果
labelQsWorkStation=QS 仓配工作台
labelRowRange=排号范围
labelSaveConfig=保存配置
labelShortStoreDeal=库存不足时的处理
labelShowSite=展示库位
labelShowType=显示方式
labelSiteGiveTime=库存分配处理时间间隔（毫秒）
labelSiteNameFormat=库位编号命名格式
labelSiteNarrow=库位紧凑
labelSiteOverview=库位一览
labelSmartCallEmptyContainer=智能呼叫空容器
labelSortOrderEntity=分拣单业务对象
labelSortOutStore=分拣出库区
labelStopAndWaring=停止并提醒
labelStoreDetail=库存明细
labelStoreFilterLineMatchField=库存筛选单行匹配字段
labelStoreScriptFunc=找库存脚本函数
labelStoreTool=仓配工作台
labelStrightOutStore=直接出库
labelStrightOutStoreReceiveOrder=直接出库承接单据
labelTotalOutNotSort=整托出，不分拣
labelTotalOutStore=整托出库区
labelWaitPackCount=待装数量
layerCountNum=层位数
ltipFillFieldSeperateDouHao=填写字段名，逗号分隔
noGive=未分配
noSelect=未选择
noTaskGoods=未取货
numLength=位数
outStoreOrder=出库单
packOrder=装货单
reqNewData=请求最新数据...
rowCountNum=排位数
runTime=执行时间
searchAnalyze=搜索、解析……
selectRow=选择排：
selectedStoreDetails=已选中 {} 条库存明细。
siteCount=库位数：
siteDoorDownFrameOrder=库口下架单
siteDoorUpFrameOrder=库口上架单
someGoodsNotConfigCount=有 {} 种物料未配置存放数量。请填写物料能装入哪些容器类型，以及在容器中最多能放几个。注意，如果容器是分格的，填写的是在每个“格子”中最多放几个
sortOrder=拣货单
startPoint=起点库位：
switch=切换
takeContainer=取走容器（容器下架）
takeContainerToSite=将容器上架到这个库位
tipMixDropFilterField=逗号分隔多个字段名。入库单行的这些字段的值必须相同才能混放。例如 'btMaterial,lotNo' 表示必须是相同物料和批次才能装入一个容器或格子。
tipRepeat={} 不能重复
tipSelectQsWorkStation=请选择一个仓配工作台
toViewContainerTransOrder=查看容器搬运单：
toViewPckOrder=查看装货单：
toViewSortOrder=查看拣货单：
totalGoodsNeedPack=共有 {} 个物料需要装入容器
transOrder=搬运单
waitDeal=待处理
whenEmptyBoxEnough=当空箱不足时

[db.backup]
btnBackupNow=立即备份
btnRestoreDbBackupFile=还原数据
confirmBackupNow=确定立即备份吗？
confirmRestoreDbBackupFile=确定要还原数据吗？您最好先备份当前数据，再还原。
labelDbBackupFiles=数据库自动备份记录
labelNoRecords=没有记录

[db.maintain]
btnClearEntity=删除全部
labelDbInspect=数据库运维

[other]
confirmToClearEntity=确定要删除全部 {} 吗？

[fleet.config.edit]
btnAddCustomChargingStrategy=添加定制充电策略
labelCbsHighW=所有机器人的求解的有界最优参数
labelCbsHighW_tip=这个参数可以限制求解的所有机器人的路径的成本，不超过最优解的几倍。很多时候不需要求得做好的路径规划，只要足够好就行。
labelCbsLowW=单个机器人的求解的有界最优参数
labelCbsLowW_tip=这个参数可以限制求解的单个机器人的路径的成本，不超过最优解的几倍。比如这个参数取 1.5，即限制求解的路径成本不超过理论最优解的 1.5 倍。
labelChargeFull=满电量 ChargeFull
labelChargeFull_tip=机器人高于“满电量”后，机器人离开充点电，去停靠。
labelChargeImportant=注意！
labelChargeImportant_tip_1=为避免电池电量可能波动带来的影响，配置各个电量时如果有大小关系要求，请确保差值在 {} 以上。
labelChargeImportant_tip_2=比如强充电量配置为 {}，够用电量请配置为 {} 以上。
labelChargeNeed=建议充电电量 ChargeNeed
labelChargeNeed_tip=机器人低于“建议充电电量”后，如果没有业务运单，会去充电。但如果有业务运单，会优先执行业务运单，暂不充电。建议充电电量必须小于满电量。
labelChargeOk=够用电量 ChargeOk
labelChargeOk_tip=机器人低于“强充电量”后必须去强充，并且充到“够用电量”后才能接单。够用电量必须小于或等于满电量。
labelChargeOnly=强充电量 ChargeOnly
labelChargeOnly_tip=低于“强充电量”后，机器人不接业务运单，必须去充电，至少充到“够用电量”后，再解除强充状态。强充电量必须小于够用电量。
labelChargeStartTimeout=起充超时
labelChargeStartTimeout_tip=单位秒。若从充电运单完成到上报开始充电的时间超过该参数配置值，系统将重新下发充电运单，让机器人退出并重新前往充电点。
labelChargingPaused=暂停自动充电
labelChargingPaused_tip=开启之后机器人将不会自动充电。
labelChargingSetting=充电配置
labelChargingStrategy=充电策略
labelClosePathDistance_tip=单位米，默认为 0.2 米。用于判断机器人是否在某条路径上。计算机器人和路径的距离，如果在此距离内，则认为机器人在此路径上。
labelCpnDispatchPeriod=光通讯派单周期
labelCpnDispatchPeriod_tip=光通讯派单周期。单位毫秒。每隔固定时间进行一次运单分派。
labelCpnEnabled=启用光通讯派单
labelCpnEnabled_tip=使用第三代光通讯派单必须启用。
labelDefaultConfig=默认配置
labelDispatchAcceptableTimeout=派单允许等待时间
labelDispatchAcceptableTimeout_tip=单位：秒。 运单等待分配时长超过该阈值时，超出部分记为“超时等待时长”。在运单排序方式中启用该因子时，仅等待时间超过该阈值的运单会按超时等待时长排序（越久越先执行），未超该阈值的仍按其他因子排序。
labelDispatchMethod=派单策略
labelDispatchMethod_tip=系统支持多种派单策略：将运单分派给机器人。DP1 是一种接近全局最优的派单策略。DP2 是一种贪心式的派单策略。
labelDispatchSetting=派单设置
labelDispatchSort=运单排序方式
labelDispatchSort_tip=按顺序点击排序因子，配置运单排序方式。默认顺序：优先级、预估执行成本、创建时间、超时等待时长。
labelDistributedSetting=TP1 交管策略配置
labelEnablePrevent=死锁预防
labelEnablePrevent_tip=建议开启。提前预防死锁。
labelFleetTrafficDevConfig=交管高级配置
labelFleetTrafficDevConfig_tip=使用方法请咨询技术支持
labelIdleTime=生成充电运单前的空闲时间
labelIdleTime_tip=单位秒。当机器人电量低于“建议充电电量”，会等待一段时间，再去充电。在此过程中如果有业务运单，机器人可以先去接单。
labelInPlaceWaitDistanceThreshold=步骤后允许接单范围
labelInPlaceWaitDistanceThreshold_tip=与"步骤后等待接单时间"参数配合使用，默认不生效，在猎鹰任务执行步骤的组件中启用"限制接单范围"后生效。默认值 0 表示仅接取当前点位的运单，大于 0 时表示接取距离当前位置指定范围内的运单。
labelInPlaceWaitSec=步骤后等待接单时间
labelInPlaceWaitSec_tip=默认值 10，单位：秒。默认不生效，仅在猎鹰任务执行步骤的组件中启用"限制接单范围"后生效。该参数用于限制机器人在完成当前步骤后，必须在当前位置或配置范围内等待指定时长，期间持续接取范围内的新运单，直到背篓满或等待超时后，才恢复正常派单。
labelLinkMaxDistance=最大解死锁的距离
labelLinkMaxDistance_tip=单位米。解环形死锁时，解死锁最大的距离约束，大于此距离的点位不作为避让点考虑，默认为 200 米。
labelLinkMinDistance=最小解死锁的距离
labelLinkMinDistance_tip=单位米。解环形死锁时，解死锁最小的距离约束，小于此距离的点位不作为避让点考虑，默认为 1 米。
labelLogHighNodes=打印高层求解日志
labelLogHighNodes_tip=调试用
labelLogLowNodes=打印低层求解日志
labelLogLowNodes_tip=调试用
labelMinChargingTime=最小充电时间
labelMinChargingTime_tip=单位秒。机器人从开始充电开始，必须至少充一段时间，才能结束充电。为保护电池，或防止机器人频繁在充电与做任务之间切换。
labelNoOpLog=关闭运行记录
labelNoOpLog_tip=系统默认将记录机器人的运行数据，以便回放。
labelNoRbkMsgLog=不记录与机器人的报文
labelNoRbkMsgLog_tip=系统默认将记录与机器人的报文，以便调试。
labelNoReallocation=停用重分派
labelNoReallocation_tip=派单系统默认会开启重分派。即把已分派给机器人的运单分派给其他更适合的机器人。或者让机器人暂停当前运单去做更适合的运单。
labelNotCancelRobot=取消执行时不向机器人发取消路径导航
labelOnPointOrPathDist=就在点位或路径上的精度
labelOpLogKeepDays=运行记录保留天数
labelOpLogKeepDays_tip=超过后自动清理更早的运行记录。
labelOpticalSetting=光通讯（临时版）配置
labelParkingCollisionCheckMode=停靠充电碰撞检测模式
labelParkingPaused=暂停自动停靠
labelParkingPaused_tip=开启之后机器人将不会自动停靠。
labelPlanCost=预估执行成本
labelPreRotate=预留旋转空间
labelPreRotate_tip=开启后，“旋转点的圆形空间资源”和“上一个点位到旋转点的路径资源”会同时申请，确保旋转动作有充足空间。推荐在机器人需频繁旋转、路径狭窄时开启。
labelReverseDeadlock=倒车解死锁
labelReverseDeadlock_tip=允许机器人倒车来解死锁
labelRobotPlanPausedOnSelfReportErrorOrFatal=机器人故障时暂停机器人接单
labelRobotPlanPausedOnSelfReportErrorOrFatal_tip=机器人上报 Error 或 Fatal 故障时，是否暂停机器人派单。
labelRobotSetting=机器人设置
labelRobotStateErrorToAutoReconnectMax=自动重连最多几次
labelRobotStateErrorToAutoReconnectMax_tip=读取失败后自动重连，如果连续重连 N 次都失败，将放弃自动重连，界面将提示人工介入，手工重连。-1 表示不限制。
labelRobotStateFailureNumToAutoConnect=读取失败几次后自动重连
labelRobotStateFailureNumToAutoConnect_tip=读取一个机器人的状态，如果连续失败次数超过这个值，将断开当前连接，重新连接。
labelRobotStateFetchDelay=机器人状态获取时间间隔
labelRobotStateFetchDelay_tip=调度定时读取所有机器人状态。单位毫秒。默认 500 毫秒。
labelTargetPath=考虑最终位置和进入路径
labelTargetPoint=仅考虑最终位置
labelTrafficMethod=路径规划策略
labelTrafficMethod_tip=系统支持多种交管策略。TP1 是一种经典的、分布式的交管策略；具备死锁侦测、解死锁和死锁预防能力；在机器人数量特别多时效率更高。TP2 是一种基于 MAPF 的交管策略；完备、有界全局最优；一般能得到更优的路径，但需要更多计算量。
labelTrafficPlanPaused=暂停路径规划
labelTrafficPlanPausedOnFailedPlan=规划失败时暂停交管规划
labelTrafficPlanPausedOnFailedPlan_tip=开启之后，如果交管规划失败，将暂停继续规划。建议仅调试时开启。
labelTrafficPlanPaused_tip=开启之后交管将暂停进行路径规划。
labelTrafficSetting=交管策略
labelUsedRobotGroup=对以下机器人组生效
labelVenusSetting=TP2 交管策略配置
labelWithdrawnMinCost=重新分派最小成本差异
labelWithdrawnMinCost_tip=单位米。只有当新旧单成本差高于这个值时才会考虑重新分派。例如设置 1.5 米，运单之前分给机器人 A，距离 10 米。但现在有机器人 B 空闲，距离运单 8 米。差值大于 1.5 米，可以重分派。
tipALessB={} 必须小于 {}
tipALessEqualB={} 必须小于或等于 {}
tipBiggerEqualZero={} 必须大于等于 0
tipBiggerZero={} 必须大于 0
tipChargingStrategyQuote=对于一个机器人，如果所在组有特殊配置，则采用组的配置，否则采用默认配置。
tipNumInChargeFull={} 必须大于 0 且 小于等于 100
tipNumInZeroToOne={} 必须大于等于 0 且 小于等于 100
tipRobotGroupNameLength=机器人组名字不超过 20 个字符

[fleet.run]
btnAi=AI 诊断
btnBackSelectQuestionType=返回选择问题类型
btnCancelAllOrder=取消所有运单
btnEmulation=仿真
btnLookAll=查看全部
btnLookAllOrder=查看全部运单
btnReAi=重新诊断
btnResetAllRobot=重置所有机器人
labelActionOption=动作（operation）
labelAiResult=诊断结果
labelAlarmRefuse=拒
labelAllOrder=全部运单
labelAtOnceDiagnose=立即诊断
labelBinTaskOption=库位任务（binTask）
labelBlocked=被阻挡
labelBusiness=业务
labelCharging=充电
labelCollisionTest=碰撞检测
labelContainerStartDirection=容器起点方向
labelContainerTargetDirection=容器目标点方向
labelCurrentStepCount=当前第 {} 步
labelDebug=调试
labelDetail=详情
labelDiagnosisObject=诊断对象
labelDoneStepCount=已完成 {} 步
labelExecFailed=执行故障
labelExecType=路径导航方式
labelFailedOrder=故障运单
labelFillContent=请补充
labelFilterQuestion=搜索问题
labelGoodsGetting=取货中
labelIdle=空闲
labelIdleAvoid=推空闲车
labelJSONValide=参数必须是合法的 JSON 格式
labelKeepOrderNum=保持单量
labelKeyLocations=目标点位
labelLatest=最新
labelLaunchOrder=发单
labelLoaded=已取货
labelLoadedPoint=取货位置
labelLocQuestion=定位问题
labelLowPower=低电量
labelMapNotSync=地图未同步
labelNeedUserHandle=人工取走
labelNoControl=无控制权
labelNoPass=未通过
labelOnlyShowUndoneOrder=仅显示未完成的运单
labelOrderNotExec=运单为什么没有继续执行？
labelOrderQuestion=运单问题
labelOrderRobotAccept=运单为什么没有机器人接？
labelOtherParams=其他参数
labelParking=停靠
labelPass=通过
labelPathPlanTest=路径规划测试
labelPlayBack=回放
labelPlayBackFile=回放文件
labelPlayBackSpeed=倍速
labelPointBind=点位绑定
labelPointOnMap=地图上的点位
labelPpt=演示
labelRobotBinStatus=机器人载货状态
labelRobotIsAcceptNewOrder=机器人能否接新单？
labelRobotIsAcceptOrder=机器人能否接单？
labelRobotIsAcceptThisOrder=机器人能否接这个单？
labelRobotIsCanCharge=机器人现在是否可以充电？
labelRobotIsForceCharge=机器人现在是否需要强制充电？
labelRobotIsNeedPark=机器人是否需要停靠？
labelRobotQuestion=机器人问题
labelRobotToPoint=机器人能否到达这个点位？
labelRobotWhyNotPlay=机器人为什么不动？
labelSchedulerSceneEdit=场景编辑
labelScriptParams=脚本参数
labelScriptStage=脚本阶段
labelSelfError=自身报错
labelSendOrder=派单
labelStartDirection=起点方向
labelStartPointName=起点名称
labelStartPointX=起点 x 坐标
labelStartPointY=起点 y 坐标
labelStep=步骤
labelTargetDirection=目标点方向
labelTargetPointName=目标点名称
labelTest=测试
labelTotalCount=共 {} 步
labelTraffic=交管
labelTrafficTP1=交管 TP1
labelTrafficTP2=交管 TP2
labelUndoneOrder=未完成运单
labelUndoneOrderCount=未完成运单数
labelUnfinished=未完成
labelUnloaded=已放货
labelUnloadedPoint=放货位置
labelWorking=工作中
tipAcceptOrderStatus=接单情况
tipCancel=确定要取消吗？
tipCancelAllOrder=确定要取消所有运单吗？
tipChargingStatus=充电情况
tipCreateOrEnableScene=请先创建或启用至少一个场景
tipEmptyRobotGroupArea=启用的机器人组、机器人、区域数量不能为零，请完善场景
tipFindQuestion=大模型帮您更快找到问题
tipInputRequired=请填入必填项
tipModelLoading=大模型诊断中，请稍后
tipMoreTime=服务器当前配置可能需要较多时间
tipOnline=确定要让机器人重新上线吗？该功能主要用于机器人断连、丢失位置等导致的交通管制问题！
tipOrderHere=这里只展示前 50 个运单，
tipPlaybackFallback=回放时不可用
tipReconnectAtOnce=立即重连
tipResetAllRobot=确定要“重置”所有机器人吗？“重置”将取消机器人的所有运单，清空机器人身上的库位状态，并将机器人重置为空闲状态。如果已载货，请确保货物已从机器人身上取走。如果遇到故障，请尽量点击“故障重试”。
tipRobotDisconnect=与机器人断连！已自动重连多次失败，请手工重连！
tipRobotNoPlay=机器人不动
tipRobotStopStatus=停靠状态
tipSelectQuestion=请选择问题

[soc.view]
labelCancelLabelPending=解除挂起
labelCancelShipmentOrderStep=确定要取消步骤 {} 吗
labelCancelSuspendOrderTip=确定要解除挂起运单 {}？
labelCreateNewSceneTip=请先创建至少一个场景
labelCurrentSceneDisabled=当前场景已停用
labelEditToEnabledScene=若要编辑请启用场景
labelFaultCount=故障数量
labelLastRunEnd=最新结束
labelLastRunStart=最新开始
labelLookFault=只看故障
labelNoScenes=当前无任何场景
labelPlayPause=播放/暂停
labelRunCount=运行次数
labelRunTimes=耗时
labelRuning=运行中
labelSceneList=场景列表
labelStartedOn=开始
labelStopped=已停止
labelSuspendOrderTip=确定要挂起运单 {}？挂起后将暂停执行。

[multiStep]
btnAddCtrl=添加控件
btnEnableMultiStep=启用多步
btnEnableMultiStepPage=启用多步界面
btnRemoveCtrl=删除控件
btnSimulationConfig=仿真配置
labeMultiStep=多步界面
labelActionTimeSpend=动作耗时
labelAddSpecialLimit=添加特殊限制
labelAllowAdd=允许添加行
labelAllowDelete=允许删除行
labelAngleOffset=角度偏差
labelArrivePointsOffset=到点偏差
labelAutoReload_tip=当前状态的详情页 3 秒自动刷新一次，对新增页面不生效
labelBlurScriptJs=失焦后触发的前端脚本
labelBlurTrigger=失焦后触发行为
labelBtnPreview=按钮预览
labelBtnTypeBuiltin=内建
labelBtnTypeExt=拓展
labelChargedLimitSpecialRule=充电点特殊限制规则
labelComponentConfigEditable=组件字段可编辑性
labelCtrlConfig=控件配置
labelCtrlField=控件字段
labelCtrlFieldOrButton=字段/按钮
labelCtrlHeight=控件高度
labelCtrlHeight_tip=指字段和按钮的高度，对应文本框、下拉列表框、按钮的几种尺寸。
labelCtrlPositionFixedTop=固定在顶部
labelCtrlPositionStatic=按照控件顺序
labelCtrlType=控件类型
labelCustomShowType=定制显示方式
labelDeleteRuleTip=删除后该规则失效，对应机器人将恢复默认权限
labelDesktopColumns=桌面端控件最大列数（正整数）
labelDesktopWidth=桌面端页面宽度
labelDisabledRobots=禁用的机器人
labelDistanceOffset=距离偏差
labelEditableType=可编辑性
labelFieldWidth=字段宽度
labelFullRow=整行
labelIntroText=说明文案
labelInvokeScriptJs=调用前端脚本
labelMainBtnConfig=主按钮配置
labelMainButtonPositionFixedBottom=固定在底部
labelMainButtonPositionStatic=控件下方
labelMobileBtnPosition=移动端按钮位置
labelMobileBtnWidth=移动端按钮宽度
labelMobileCtrlPosition=移动端控件位置
labelNextState=触发下一状态
labelNullSpecialRuleLimitd=暂无特殊限制规则
labelPageIntro=页面说明
labelRobotChargeStopedBind=停靠、充电点与机器人的绑定
labelRobotsChargedBind=充电点与机器人的绑定
labelRobotsChargedBindOpenSetting=如果因为业务需求，不允许机器人到特定充电点充电，请添加定制策略。
labelRobotsChargedBindTip=机器人组地图中存在的充电点默认允许该组的所有机器人使用，不需要额外为充电点绑定机器人。
labelRobotsChargedSpecialLimit=启用充电点特殊限制
labelRobotsStoppedBind=停靠点与机器人的绑定
labelRobotsStoppedBindOpenSetting=如果因为业务需求，不允许机器人到特定停靠点停靠，请添加定制策略。
labelRobotsStoppedBindTip=机器人组地图中存在的 PP 点和所有“允许停靠”属性为是的点，默认允许该组的所有机器人使用，不需要额外为停靠点绑定机器人。
labelRobotsStoppedSpecialLimit=启用停靠点特殊限制
labelShowTypeScriptJs=定制显示方式的前端脚本
labelSizeLarge=大
labelSizeMiddle=中
labelSizeSmall=小
labelSizeSuperLarge=特大
labelStateConfig=状态配置
labelStatusValueEnOrNum_tip=状态标识 必须由英文和数字组成
labelStoppedLimitSpecialRule=停靠点特殊限制规则
labelToList=打开列表界面
labelUpdateState=修改状态并保存
labelapproveMutiSelect=可多选。
labelselectedRobotsBindChargesTip=选择的机器人将被禁止使用该充电点，未选择的机器人仍默认允许。
labelselectedRobotsBindParksTip=选择的机器人将被禁止使用该停靠点，未选择的机器人仍默认允许。
tipDuplicateRule=该限制已存在，无需重复添加
tipMultiStepOrBzKind=多步界面和业务类型只能同时启用一个
tipPointsRobotsRequire=点位与禁用的机器人必填
tipRealRobotsArrivePointsOffset=模拟真实机器人的到点精度偏差。
tipTimeShorter=时间间隔越短，仿真机器人充电越快。
tipTimeShorterForCost=时间间隔越短，仿真机器人耗电越快。

[scene.policies]
btnAddPolicy=添加定制策略
labelCycleBased=按电池循环次数
labelCycleRange=周期范围
labelDateRange=日期范围
labelDefault=默认
labelDisableChargePoint=禁用充电点
labelDisableParkPoint=禁用停靠点
labelEnableRobotGroupCustomization=启用机器人组定制
labelEnableTimeCustomization=启用时间定制
labelEveryDay=每天
labelExcludedRobotGroups=排除机器人组
labelExcludedRobots=排除机器人
labelIncludedRobotGroups=包括机器人组
labelIncludedRobots=包括机器人
labelMaintainCharge=开启维保充电
labelMaintainChargeText=维保充电
labelMaintainChargeTip=电池使用一段时间之后需要强制进行一次维保充电，即充到满电量，以进行电量校准。
labelMaintainLoop=维保充电循环次数
labelMaintenanceBatteryCycleCount=维保充电电池循环次数
labelMaintenanceBatteryCycleCountTip=默认为空。电池 N 次充放循环后，触发一次维保充电。
labelMaintenanceChargeMode=维保充电方式
labelMaintenanceHoldMinutes=充满后持续充电时间
labelMaintenanceHoldMinutesTip=默认 30 分钟。电量达到充满电量后，持续充电的时间。
labelMaintenanceScriptFunction=脚本函数
labelMaintenanceTargetSoc=维保充电充满电量
labelMaintenanceTargetSocTip=默认为空，达到该电量视为“充满”；为空则充到 ChargeFull。
labelMaintenanceTimePeriodDays=维保充电周期
labelMaintenanceTimePeriodDaysTip=默认 30 天。每 N 天触发一次维保充电。
labelPolicyName=策略名称
labelRenamePolicyName=重命名定制策略
labelScriptBased=脚本定制
labelTimeBased=按时间周期
labelTimeRange=时刻范围
labelWeekRange=星期范围
labelWeekends=周末
labelWorkdays=工作日
tipAddPolicy=支持根据时间和机器人定制策略。每个策略有一个顺序属性，按此顺序匹配机器人，匹配到则使用该策略，如果最终都匹配不到，使用默认策略。
tipCustomizeRg=包括和排除请注意逻辑关系，例如同一机器人组不要同时选择包括和排除。
tipDateRanges=各类日期时间范围，不填表示不限制。
tipPolicyDesc=支持每个配置项根据时间和机器人添加多个定制策略，配置多个策略情况下，按照策略从上到下依次匹配机器人，匹配到则使用该策略，未匹配到的机器人则使用默认策略。
tipPolicyName=请输入策略名称
tipRemovePolicy=确认删除策略吗？

[ai.llm]
labelAIClientInitedError=客户端初始化失败
labelAIClientInitedSuccess=客户端初始化成功
labelAIClientIniting=客户端初始化中…
labelApiConnection=接口通讯
labelAutoExecution=自动执行
labelClosePointOrPathDistance=判断机器人在点位或路径上，允许的最大距离
labelClosePointOrPathDistance_tip=单位 m，默认 0.3 m。粗精度配置，用于当细精度采信条件未满足时，筛选候选范围。仅当机器人当前位置与点位 / 路径的距离小于此值时，该点位 / 路径起点才会进入起点候选列表，在其中选择最近的。
labelFriForSimple=周五
labelGoToNextError=下一个错误时段
labelGoToNextRobotFrame=下一个运动时段
labelGoToPrevError=上一个错误时段
labelGoToPrevRobotFrame=上一个运动时段
labelInitTheta=出生朝向（角度 -180° ~ 180°）
labelInputQuestions=输入问题
labelLocalNoTransferOrder=本地无此运单
labelManualExecution=手动执行
labelMessageAlarm=消息提醒
labelMessageCenter=消息中心
labelMonForSimple=周一
labelNoPreview=暂无预览
labelOnPointOrPathDist_tip=单位 m，默认 0.04 m。细精度配置，用于采信判断。当机器人当前位置与推测的点位 / 路径的距离小于此值时，直接采信 “机器人就在该点位 / 路径上”，并以点位或路径起点作为规划起点。
labelPeopleDeal=人工处理
labelPleaseCheckAndWriteFloor=请先勾选工作区域填写楼层顺序
labelPushMapCostMax=推送切换地图的最大耗时
labelPushMapCostMin=推送切换地图的最小耗时
labelReSend=重发
labelSatForSimple=周六
labelSelectGroup=选择分组
labelSunForSimple=周日
labelSysThemeColor=系统主题色
labelTargetLocation=目标位置
labelTcpResponseDelayMax=TCP 响应延迟最大值
labelTcpResponseDelayMin=TCP 响应延迟最小值
labelThuForSimple=周四
labelTusForSimple=周二
labelUsuallyUsedQuestions=常见问题
labelViewAllMessage=查看所有消息
labelWedForSimple=周三
label_AIModuleQusFor=向 M4 大模型提问
label_auto_send_voice_record=自动发送语音
label_auto_voice_recorder=自动
label_call_way=调用方式
label_click_start_voice_record=点击开始录制语音
label_compatible_mode=兼容模式
label_frequently_asked_questions=常用问题
label_handle_send_voice_record=手动发送语音
label_handle_voice_recorder=手动
label_home_input_item=搜索菜单项
label_init_voice_record=语音初始化
label_microphone_permission_field=麦克风权限获取失败
label_module_helper=大模型助手
label_pause_response=停止生成回答
label_recognized_field=识别失败
label_recognizing=识别中
label_recording_voice=录制中
label_send=发送
label_switch_components_panel=组件面板
label_switch_components_settings=组件配置
label_switch_show_has_value=仅显示有值的参数
label_switch_variable_panel=变量面板
label_voice_result_send_method=语音发送方式
lebelDelayExecution=延时执行
message_delay_second_excute={} 秒后自动执行
message_will_get_info_from_msg=将要调用函数 {} 获取信息。

[permission.config]
permission_Alarm_Read=查看
permission_Alarm_Read_tip=页面右侧显示“告警”图标，点击后打开告警页面。​
permission_Alarm_Stop=急停
permission_Alarm_Stop_tip=告警页面显示“stop”图标。
permission_BinOverview_Menu=菜单
permission_BinOverview_Menu_tip=如果配置了菜单，菜单栏显示“库位一览”。
permission_BinOverview_Read=查看和操作
permission_BinOverview_Read_tip=页面显示内容，并可以对页面放大、缩小、设置显示方式。
permission_CeTest_Menu=菜单
permission_CeTest_Menu_tip=如果配置了菜单，菜单栏显示“CeTest”。
permission_CeTest_Read=查看
permission_CeTest_Read_tip=页面显示内容且可进行全部操作。
permission_ConfigMenu_AddGroup=添加菜单组
permission_ConfigMenu_AddGroup_tip=“菜单配置”页面显示“添加菜单组”按钮。
permission_ConfigMenu_AddItem=添加菜单项
permission_ConfigMenu_AddItem_tip=“菜单配置”页面显示“添加菜单项”按钮。
permission_ConfigMenu_Read=查看
permission_ConfigMenu_Read_tip=菜单栏显示“配置菜单”按钮，点击后打开“菜单配置”页面。
permission_ConfigMenu_RemoveGroup=删除菜单组
permission_ConfigMenu_RemoveGroup_tip=“菜单配置”页面显示“删除”图标。
permission_ConfigMenu_RmoveItem=删除菜单项
permission_ConfigMenu_RmoveItem_tip=“菜单配置”页面显示“删除”图标。
permission_Dashboard_Config=配置
permission_Dashboard_Config_tip=显示“配置”图标，点击后可以增加区块、删除区块、选择区块展示内容。
permission_Dashboard_Menu=菜单
permission_Dashboard_Menu_tip=如果配置了菜单，菜单栏显示“运营看板”。
permission_Dashboard_Read=查看
permission_Dashboard_Read_tip=如果区块配置的页面用户有权限，区块显示内容。
permission_DataDict_Menu=菜单
permission_DataDict_Menu_tip=如果配置了菜单，菜单栏显示“数据字典”。
permission_DataDict_Read=查看
permission_DataDict_Read_tip=页面显示内容且可进行全部操作。
permission_DbBackupFiles_Backup=立即备份
permission_DbBackupFiles_Backup_tip=显示“立即备份”按钮。
permission_DbBackupFiles_Menu=菜单
permission_DbBackupFiles_Menu_tip=如果配置了菜单，菜单栏显示“数据库自动备份记录”。
permission_DbBackupFiles_Read=查看
permission_DbBackupFiles_Read_tip=页面显示内容。
permission_DbBackupFiles_Remove=删除
permission_DbBackupFiles_Remove_tip=显示“删除”按钮。
permission_DbBackupFiles_Restore=还原数据
permission_DbBackupFiles_Restore_tip=已经备份记录中显示“还原数据”。
permission_DbInspect_Menu=菜单
permission_DbInspect_Menu_tip=如果配置了菜单，菜单栏显示“数据库运维”。
permission_DbInspect_Read=查看
permission_DbInspect_Read_tip=页面显示内容且可进行全部操作。
permission_Demo_Menu=菜单
permission_Demo_Menu_tip=如果配置了菜单，菜单栏显示“UI Demo”。
permission_Demo_Read=查看
permission_Demo_Read_tip=页面显示内容且可进行全部操作。
permission_Display_Read=查看
permission_Display_Read_tip=页面右上角显示“显示调整”图标。
permission_FalconTaskDefList_CopyBp=复制定制组件
permission_FalconTaskDefList_CopyBp_tip=显示“复制”图标。
permission_FalconTaskDefList_CopyTaskDef=复制任务模板
permission_FalconTaskDefList_CopyTaskDef_tip=显示“复制”图标。
permission_FalconTaskDefList_CreateBp=添加定制组件
permission_FalconTaskDefList_CreateBp_tip=显示“添加定制组件”按钮。
permission_FalconTaskDefList_CreateTaskDef=添加任务模板
permission_FalconTaskDefList_CreateTaskDef_tip=显示“添加任务模板”按钮。
permission_FalconTaskDefList_DeleteBp=删除定制组件
permission_FalconTaskDefList_DeleteBp_tip=显示“删除”按钮。
permission_FalconTaskDefList_Export=导出
permission_FalconTaskDefList_Export_tip=导出任务模板和定制组件。
permission_FalconTaskDefList_HistoryBp=查看定制组件历史
permission_FalconTaskDefList_HistoryBp_tip=显示“历史”图标。
permission_FalconTaskDefList_HistoryTaskDef=查看任务模板历史
permission_FalconTaskDefList_HistoryTaskDef_tip=显示“历史”图标。
permission_FalconTaskDefList_Import=导入
permission_FalconTaskDefList_Import_tip=导入任务模板和定制组件。
permission_FalconTaskDefList_Menu=菜单
permission_FalconTaskDefList_Menu_tip=如果配置了菜单，菜单栏显示“任务模板”。
permission_FalconTaskDefList_Read=查看
permission_FalconTaskDefList_ReadAndEditBp=查看编辑定制组件
permission_FalconTaskDefList_ReadAndEditBp_tip=点击定制的组件，进入自定义组件页面。
permission_FalconTaskDefList_Read_tip=页面显示内容。
permission_FalconTaskDefList_RemoveTaskDef=删除任务模板
permission_FalconTaskDefList_RemoveTaskDef_tip=显示“删除”按钮。
permission_FleetDev_Menu=菜单
permission_FleetDev_Menu_tip=如果配置了菜单，菜单栏显示“调度开发”。
permission_FleetDev_Read=查看
permission_FleetDev_Read_tip=页面显示内容且可进行全部操作。
permission_FleetScene_Debug=场景调试
permission_FleetScene_Debug_tip=显示调试面板所有按钮，如：取消所有运单、重置所有机器人。
permission_FleetScene_DeviceControl=调度设备管控
permission_FleetScene_DeviceControl_tip=显示开门关门、呼叫电梯按钮。
permission_FleetScene_Edit=调度场景编辑
permission_FleetScene_Edit_tip=显示“编辑”按钮，打开“场景编辑”菜单。如：导入导出场景、启用停用场景、地图拉取推送，控制门、电梯、容器类型、停用机器人等。
permission_FleetScene_MapEdit=地图编辑
permission_FleetScene_MapEdit_tip=显示地图编辑按钮；启用、停用地图按钮。
permission_FleetScene_OrderControl=运单管控
permission_FleetScene_OrderControl_tip=显示运单所有操作类修改类按钮，如取消、挂起；显示发单界面所有按钮，如：添加简单、复杂测试，配置随机发单。
permission_FleetScene_Remove=删除场景
permission_FleetScene_Remove_tip=编辑页面显示“删除场景”按钮。
permission_FleetScene_RobotControl=机器人管控
permission_FleetScene_RobotControl_tip=显示机器人所有操作类修改类按钮，如可接单、获取控制权。
permission_FleetScene_RobotReset=重置机器人
permission_FleetScene_RobotReset_tip=显示机器人重置按钮。
permission_FleetScene_Sim=仿真管理
permission_FleetScene_Sim_tip=调度场景（运行）界面，显示仿真按钮。
permission_FleetScene_View=调度场景查看
permission_FleetScene_View_tip=显示“调度场景”菜单，对整个调度场景界面进行查看。
permission_GlobalVariable_CreateVar=定义变量
permission_GlobalVariable_CreateVar_tip=显示定义变量、新增变量、添加备注、导入、导出、删除按钮。
permission_GlobalVariable_Menu=菜单
permission_GlobalVariable_Menu_tip=如果配置了菜单，菜单栏显示“全局变量”。
permission_GlobalVariable_Read=查看
permission_GlobalVariable_Read_tip=可以查看页面显示的内容，显示修改变量按钮，仅能修改变量的值。
permission_Gw_Menu=菜单
permission_Gw_Menu_tip=如果配置了菜单，菜单栏显示“网关配置”。
permission_Gw_Read=查看
permission_Gw_Read_tip=页面显示内容且可进行全部操作。
permission_MapView_Edit=编辑
permission_MapView_Edit_tip=显示“编辑”按钮，点击后切换为编辑模式。
permission_MapView_Menu=菜单
permission_MapView_Menu_tip=如果配置了菜单，菜单栏显示“地图”。
permission_MapView_Read=查看
permission_MapView_Read_tip=页面显示内容。
permission_MetaIndex_Create=添加业务对象
permission_MetaIndex_Create_tip=显示“添加业务对象”按钮。
permission_MetaIndex_Detail=查看详情
permission_MetaIndex_Detail_tip=点击业务对象名，跳转到业务对象编辑页面。
permission_MetaIndex_Fix=修复业务对象
permission_MetaIndex_Fix_tip=显示“修复”按钮。
permission_MetaIndex_Menu=菜单
permission_MetaIndex_Menu_tip=如果配置了菜单，菜单栏显示“业务对象”。运维中心显示“业务对象”。
permission_MetaIndex_Read=列表
permission_MetaIndex_Read_tip=列表页显示内容。
permission_MetaIndex_Reset=重置
permission_MetaIndex_ResetBuiltin=重置内建
permission_MetaIndex_ResetBuiltin_tip=显示“重置内建”按钮。
permission_MetaIndex_Reset_tip=显示“重置”按钮。
permission_MetaIndex_UpdateDb=更新数据库结构
permission_MetaIndex_UpdateDb_tip=显示“更新数据库结构”按钮。
permission_MockIndex_Menu=菜单
permission_MockIndex_Menu_tip=如果配置了菜单，菜单栏显示“仿真中心”。“调度场景”运行界面显示“仿真”按钮。
permission_Note_Read=查看
permission_Note_Read_tip=页面右侧显示“便签”图标。
permission_OpControl_Core=常用
permission_OpControl_Core_tip=显示“常用”组名，显示组内有权限的菜单入口。
permission_OpControl_Db=数据库
permission_OpControl_Db_tip=显示“数据库”组名，显示组内有权限的菜单入口。
permission_OpControl_DownloadLog=下载日志
permission_OpControl_DownloadLog_tip=显示“下载日志”组名，显示组内有权限的菜单入口。
permission_OpControl_Menu=菜单
permission_OpControl_Menu_tip=如果配置了菜单，菜单栏显示“运维中心”。
permission_OpControl_OtherFn=附加功能
permission_OpControl_OtherFn_tip=显示“附加功能”组名，显示组内有权限的菜单入口。
permission_OpControl_Outdated=过时功能
permission_OpControl_Outdated_tip=显示“过时功能”组名，显示组内有权限的菜单入口。
permission_PeriodicReport_Copy=复制方案
permission_PeriodicReport_Copy_tip=在方案详情页，显示“复制方案”按钮。
permission_PeriodicReport_Create=新增方案
permission_PeriodicReport_Create_tip=左侧显示“新方案”按钮。
permission_PeriodicReport_Edit=编辑方案
permission_PeriodicReport_Edit_tip=已有的方案页面，显示“保存”按钮。
permission_PeriodicReport_Export=导出为 Excel
permission_PeriodicReport_Export_tip=显示“导出为 Excel”按钮，点击后将统计数据导出。
permission_PeriodicReport_Menu=菜单
permission_PeriodicReport_Menu_tip=如果配置了菜单，菜单栏显示“周期报表”。
permission_PeriodicReport_Read=查看
permission_PeriodicReport_Read_tip=页面显示内容。
permission_PeriodicReport_Remove=删除方案
permission_PeriodicReport_Remove_tip=在方案详情页，显示“删除方案”按钮。
permission_PlcPanel_Create=添加面板
permission_PlcPanel_Create_tip=显示“添加”按钮。
permission_PlcPanel_Edit=配置面板
permission_PlcPanel_Edit_tip=已添加的设备面板中，显示“配置”图标。
permission_PlcPanel_Menu=菜单
permission_PlcPanel_Menu_tip=如果配置了菜单，菜单栏显示“PLC 设备面板”。
permission_PlcPanel_Read=查看
permission_PlcPanel_Read_tip=页面显示内容。
permission_QsWorkStationUi_Menu=菜单
permission_QsWorkStationUi_Menu_tip=如果配置了菜单，菜单栏显示“QS 仓配工作台”。
permission_QsWorkStationUi_Read=查看和编辑
permission_QsWorkStationUi_Read_tip=页面显示内容并可进行全部操作。
permission_RobotAppIndex_ConfigScene=配置场景
permission_RobotAppIndex_ConfigScene_tip=运行页面显示“配置”按钮。
permission_RobotAppIndex_Menu=菜单
permission_RobotAppIndex_Menu_tip=如果配置了菜单，菜单栏显示“机器人应用管理”。
permission_RobotAppIndex_Read=查看
permission_RobotAppIndex_Read_tip=页面显示内容。
permission_RobotAppIndex_RobotEdit=机器人操作
permission_RobotAppIndex_RobotEdit_tip=包括可接单、不接单、不可接单不占资源、获取控制权、释放控制权、暂停路径导航、恢复路径导航、软急停、取消软急停、清除机器人告警、确认定位。
permission_ServerFiles_Menu=菜单
permission_ServerFiles_Menu_tip=如果配置了菜单，菜单栏显示“服务器文件管理”。
permission_ServerFiles_Read=查看
permission_ServerFiles_Read_tip=页面显示内容且可进行全部操作。
permission_SimpleValuePage_Menu=菜单
permission_SimpleValuePage_Menu_tip=如果配置了菜单，菜单栏显示“我的桌面”。
permission_SingleAppIndex_FaultAction=故障看板操作
permission_SingleAppIndex_FaultAction_tip=清错
permission_SingleAppIndex_Menu=菜单
permission_SingleAppIndex_Menu_tip=如果配置了菜单，菜单栏显示“单车应用”。
permission_SingleAppIndex_MoveAction=移动操作
permission_SingleAppIndex_MoveAction_tip=包括摇杆、暂停移动、切换高中低速、设置（设置机器人速度阈值）。
permission_SingleAppIndex_NavAction=导航操作
permission_SingleAppIndex_NavAction_tip=包括导航到站点、取消导航、继续导航、暂停导航。
permission_SingleAppIndex_OrderAction=运单操作
permission_SingleAppIndex_OrderAction_tip=包括创建单车运单、取消单车运单、运单故障重试。
permission_SingleAppIndex_OrgAction=机构操作
permission_SingleAppIndex_OrgAction_tip=根据车型显示机器人机构操作、配置（自定义机构操作）。
permission_SingleAppIndex_Read=查看
permission_SingleAppIndex_Read_tip=页面显示内容。
permission_SingleAppIndex_RobotEdit=机器人操作
permission_SingleAppIndex_RobotEdit_tip=包括获取/释放控制权、上传图片、更多（配置机器人卡片显示项）。
permission_SmapViewer_Menu=菜单
permission_SmapViewer_Menu_tip=如果配置了菜单，菜单栏显示“Smap 查看器”。
permission_SmapViewer_Read=查看
permission_SmapViewer_Read_tip=页面显示内容且可进行全部操作。
permission_SocPage_Menu=菜单
permission_SocPage_Menu_tip=页面右侧显示“系统监控”图标。如果配置了菜单，菜单栏显示“系统监控”。
permission_SocPage_Read=查看
permission_SocPage_Read_tip=“系统监控”页面显示内容。
permission_StatsDashboard_Config=配置
permission_StatsDashboard_Config_tip=显示“配置”图标，点击后可以增加区块、删除区块、选择区块展示内容。
permission_StatsDashboard_Menu=菜单
permission_StatsDashboard_Menu_tip=如果配置了菜单，菜单栏显示“统计看板”。
permission_StatsDashboard_Read=查看
permission_StatsDashboard_Read_tip=如果区块配置的页面用户有权限，区块显示内容。
permission_SystemConfig_Falcon=猎鹰任务
permission_SystemConfig_Falcon_tip=显示“猎鹰任务”标签。
permission_SystemConfig_Menu=菜单
permission_SystemConfig_Menu_tip=如果配置了菜单，菜单栏显示“系统配置”。admin 下拉菜单中显示“系统配置”入口。
permission_SystemConfig_ScBasic=基础配置
permission_SystemConfig_ScBasic_tip=显示“基础配置”标签。
permission_SystemConfig_ScData=数据管理
permission_SystemConfig_ScData_tip=显示“数据管理”标签。
permission_SystemConfig_ScDev=开发配置
permission_SystemConfig_ScDev_tip=显示“开发配置”标签。
permission_SystemConfig_ScFile=文件
permission_SystemConfig_ScFile_tip=显示“文件”标签。
permission_SystemConfig_ScLogin=第三方登录
permission_SystemConfig_ScLogin_tip=显示“第三方登录”标签。
permission_SystemConfig_ScQuickStore=QuickStore
permission_SystemConfig_ScQuickStore_tip=显示“QuickStore”标签。
permission_SystemConfig_ScSingle=单车应用
permission_SystemConfig_ScSingle_tip=显示“单车应用”标签。
permission_SystemConfig_ScStat=统计
permission_SystemConfig_ScStat_tip=显示“统计”标签。
permission_SystemConfig_ScUi=界面配置
permission_SystemConfig_ScUi_tip=显示“界面”标签。
permission_SystemConfig_ScUserSecurity=用户安全
permission_SystemConfig_ScUserSecurity_tip=显示“用户安全”标签。
permission_SystemConfig_ScWcs=车队管理
permission_SystemConfig_ScWcs_tip=显示“车队管理”标签。
permission_SystemConfig_ScWms=仓储业务
permission_SystemConfig_ScWms_tip=显示“仓储业务”标签。
permission_TomOrderIndex_Detail=查看详情
permission_TomOrderIndex_Detail_tip=点击单号，显示运单详情页。
permission_TomOrderIndex_Menu=菜单
permission_TomOrderIndex_Menu_tip=如果配置了菜单，菜单栏显示“调度（CORE）运单”。
permission_TomOrderIndex_Read=列表
permission_TomOrderIndex_Read_tip=列表页显示内容。
permission_TomOrderIndex_Seal=封口
permission_TomOrderIndex_Seal_tip=列表和详情页显示“封口”按钮。
permission_TomOrderIndex_SetPriority=设置优先级
permission_TomOrderIndex_SetPriority_tip=列表页显示“设置优先级”按钮。
permission_TomOrderIndex_Terminate=终止运单
permission_TomOrderIndex_Terminate_tip=列表和详情页显示“终止运单”按钮。
permission_UserAlertPage_Read=查看
permission_UserAlertPage_Read_tip=右上角显示 “消息”图标，点击后进入“消息”页面。
